filename,cell_type,x1,x2,y1,y2,content,img_width,img_height,bb_width,bb_height
photo-0.jpg,2,1306,1336,1683,1847,Pies Beef (2),2448,3264,30,164
photo-0.jpg,2,1338,1369,1616,1846,Pies Vegetable (2),2448,3264,31,230
photo-0.jpg,2,1367,1402,1486,1847,Spinach & Fetta Turnover (3),2448,3264,35,361
photo-0.jpg,2,1398,1435,1534,1846,Party Sausage Rolls (12),2448,3264,37,312
photo-0.jpg,2,1433,1461,1633,1844,Bread Stick Herb,2448,3264,28,211
photo-0.jpg,2,1463,1492,1619,1845,Bread Stick Garlic,2448,3264,29,226
photo-0.jpg,2,1495,1524,1595,1846,Bread Sticks Plain -,2448,3264,29,251
photo-0.jpg,2,1529,1561,1672,1847,Lamington (6),2448,3264,32,175
photo-0.jpg,2,1559,1589,1573,1846,Muffins Choc Chip (2),2448,3264,30,273
photo-0.jpg,2,1588,1622,1481,1845,Muffins Raspberry Delight (2),2448,3264,34,364
photo-0.jpg,2,1624,1654,1590,1846,Donut-Cinnamon (8),2448,3264,30,256
photo-0.jpg,2,1656,1686,1611,1845,Eclairs Custard (3),2448,3264,30,234
photo-0.jpg,2,1687,1717,1544,1847,Slice - Rum & Raisin (6),2448,3264,30,303
photo-0.jpg,2,1720,1752,1632,1847,Slice - Cherry (6),2448,3264,32,215
photo-0.jpg,2,1756,1786,1742,1845,Delivery,2448,3264,30,103
photo-0.jpg,1,1275,1301,352,423,34.75,2448,3264,26,71
photo-0.jpg,1,1309,1334,350,424,34.75,2448,3264,25,74
photo-0.jpg,1,1340,1367,350,422,32.80,2448,3264,27,72
photo-0.jpg,1,1372,1397,348,419,32.84,2448,3264,25,71
photo-0.jpg,1,1405,1429,347,419,31.44,2448,3264,24,72
photo-0.jpg,1,1437,1461,346,418,31.44,2448,3264,24,72
photo-0.jpg,1,1468,1493,345,417,31.44,2448,3264,25,72
photo-0.jpg,1,1500,1526,343,416,27.84,2448,3264,26,73
photo-0.jpg,1,1532,1558,341,414,22.00,2448,3264,26,73
photo-0.jpg,1,1565,1590,341,413,22.00,2448,3264,25,72
photo-0.jpg,1,1597,1623,340,412,55.00,2448,3264,26,72
photo-0.jpg,1,1630,1655,336,409,21.56,2448,3264,25,73
photo-0.jpg,1,1662,1687,334,408,28.16,2448,3264,25,74
photo-0.jpg,1,1695,1721,334,407,28.08,2448,3264,26,73
photo-0.jpg,1,1727,1752,332,405,36.00,2448,3264,25,73
photo-0.jpg,1,1283,1307,537,592,3.16,2448,3264,24,55
photo-0.jpg,1,1289,1312,813,868,6.95,2448,3264,23,55
photo-0.jpg,1,1295,1321,1126,1210,5.0000,2448,3264,26,84
photo-0.jpg,3,1292,1317,1010,1086,EACH,2448,3264,25,76
photo-0.jpg,1,1327,1352,1124,1209,5.0000,2448,3264,25,85
photo-0.jpg,3,1324,1349,1008,1084,EACH,2448,3264,25,76
photo-0.jpg,1,1359,1384,1124,1209,5.0000,2448,3264,25,85
photo-0.jpg,3,1356,1381,1008,1083,EACH,2448,3264,25,75
photo-0.jpg,1,1391,1415,1123,1208,4.0000,2448,3264,24,85
photo-0.jpg,3,1387,1413,1007,1082,EACH,2448,3264,26,75
photo-0.jpg,1,1422,1447,1122,1206,8.0000,2448,3264,25,84
photo-0.jpg,3,1419,1444,1005,1082,EACH,2448,3264,25,77
photo-0.jpg,1,1454,1479,1123,1206,8.0000,2448,3264,25,83
photo-0.jpg,3,1451,1476,1006,1080,EACH,2448,3264,25,74
photo-0.jpg,1,1486,1510,1122,1206,8.0000,2448,3264,24,84
photo-0.jpg,3,1482,1508,1005,1080,EACH,2448,3264,26,75
photo-0.jpg,1,1518,1542,1120,1207,4.0000,2448,3264,24,87
photo-0.jpg,3,1514,1540,1003,1080,EACH,2448,3264,26,77
photo-0.jpg,1,1550,1574,1121,1204,5.0000,2448,3264,24,83
photo-0.jpg,3,1547,1573,1003,1078,EACH,2448,3264,26,75
photo-0.jpg,1,1583,1607,1119,1205,5.0000,2448,3264,24,86
photo-0.jpg,3,1579,1605,1003,1078,EACH,2448,3264,26,75
photo-0.jpg,1,1615,1640,1116,1218,10.0000,2448,3264,25,102
photo-0.jpg,3,1611,1637,1001,1078,EACH,2448,3264,26,77
photo-0.jpg,1,1647,1671,1117,1202,4.0000,2448,3264,24,85
photo-0.jpg,3,1644,1669,1000,1075,EACH,2448,3264,25,75
photo-0.jpg,1,1679,1704,1117,1202,4.0000,2448,3264,25,85
photo-0.jpg,3,1676,1701,999,1075,EACH,2448,3264,25,76
photo-0.jpg,1,1712,1736,1116,1203,4.0000,2448,3264,24,87
photo-0.jpg,3,1709,1734,999,1075,EACH,2448,3264,25,76
photo-0.jpg,1,1744,1768,1115,1201,2.0000,2448,3264,24,86
photo-0.jpg,3,1740,1766,998,1074,EACH,2448,3264,26,76
photo-0.jpg,3,1313,1337,2043,2097,GF1,2448,3264,24,54
photo-0.jpg,1,1314,1338,535,591,3.16,2448,3264,24,56
photo-0.jpg,1,1321,1345,813,867,6.95,2448,3264,24,54
photo-0.jpg,3,1344,1370,2040,2097,GF6,2448,3264,26,57
photo-0.jpg,3,1346,1370,515,590,2.98 .,2448,3264,24,75
photo-0.jpg,1,1353,1376,810,866,6.56,2448,3264,23,56
photo-0.jpg,3,1376,1401,2023,2097,GF22,2448,3264,25,74
photo-0.jpg,3,1407,1433,2006,2098,GF120,2448,3264,26,92
photo-0.jpg,3,1440,1465,2007,2096,GF150,2448,3264,25,89
photo-0.jpg,3,1472,1496,2012,2096,GF151,2448,3264,24,84
photo-0.jpg,3,1504,1528,2009,2098,GF152,2448,3264,24,89
photo-0.jpg,3,1535,1560,2024,2098,GF30,2448,3264,25,74
photo-0.jpg,3,1567,1592,2025,2098,GF43,2448,3264,25,73
photo-0.jpg,3,1599,1625,2025,2099,GF44,2448,3264,26,74
photo-0.jpg,3,1632,1657,2024,2100,GF84,2448,3264,25,76
photo-0.jpg,3,1665,1690,2025,2099,GF85,2448,3264,25,74
photo-0.jpg,3,1697,1721,2010,2100,GF100,2448,3264,24,90
photo-0.jpg,3,1729,1754,2010,2101,GF104,2448,3264,25,91
photo-0.jpg,1,1378,1401,534,587,2.99,2448,3264,23,53
photo-0.jpg,1,1384,1408,814,865,8.21,2448,3264,24,51
photo-0.jpg,1,1410,1434,532,588,0.00,2448,3264,24,56
photo-0.jpg,1,1416,1440,809,865,3.93,2448,3264,24,56
photo-0.jpg,1,1441,1466,531,586,0.00,2448,3264,25,55
photo-0.jpg,1,1449,1471,808,862,3.93,2448,3264,22,54
photo-0.jpg,1,1473,1499,530,585,0.00,2448,3264,26,55
photo-0.jpg,1,1480,1504,807,862,3.93,2448,3264,24,55
photo-0.jpg,1,1506,1530,529,584,2.53,2448,3264,24,55
photo-0.jpg,1,1512,1536,806,861,6.96,2448,3264,24,55
photo-0.jpg,1,1538,1562,527,583,2.00,2448,3264,24,56
photo-0.jpg,1,1544,1568,805,861,4.40,2448,3264,24,56
photo-0.jpg,1,1570,1594,527,582,2.00,2448,3264,24,55
photo-0.jpg,1,1576,1599,804,860,4.40,2448,3264,23,56
photo-0.jpg,1,1602,1627,527,581,5.00,2448,3264,25,54
photo-0.jpg,1,1608,1632,802,859,5.50,2448,3264,24,57
photo-0.jpg,1,1635,1658,523,576,1.96,2448,3264,23,53
photo-0.jpg,1,1640,1664,801,856,5.39,2448,3264,24,55
photo-0.jpg,1,1667,1692,522,577,256,2448,3264,25,55
photo-0.jpg,1,1674,1697,801,856,7.04,2448,3264,23,55
photo-0.jpg,1,1699,1724,521,577,255,2448,3264,25,56
photo-0.jpg,1,1706,1729,801,856,7.02,2448,3264,23,55
photo-0.jpg,1,1732,1756,519,576,3.27,2448,3264,24,57
photo-0.jpg,1,1737,1762,798,869,18.00,2448,3264,25,71
photo-0.jpg,3,1762,1786,2078,2099,D,2448,3264,24,21
photo-1.jpg,2,1002,1026,1966,2212,2NDS ASST PIES,2448,3264,24,246
photo-1.jpg,1,1001,1027,671,774,$163.64,2448,3264,26,103
photo-1.jpg,1,1002,1029,952,1041,$12.00,2448,3264,27,89
photo-1.jpg,1,1006,1028,1257,1287,15,2448,3264,22,30
photo-1.jpg,1,999,1025,379,484,$180.00,2448,3264,26,105
photo-2.jpg,2,1004,1028,1870,2093,2NDS ASST PIES,2448,3264,24,223
photo-2.jpg,1,1017,1040,956,1037,$12.00,2448,3264,23,81
photo-2.jpg,1,1016,1036,1229,1257,18,2448,3264,20,28
photo-2.jpg,1,1021,1043,699,794,$196.36,2448,3264,22,95
photo-2.jpg,1,1024,1047,438,531,$216.00,2448,3264,23,93
photo-3.jpg,2,2295,2753,1728,1753,NORCO FULL CREAM MILK 3LT,2448,3264,458,25
photo-3.jpg,1,2790,2939,1729,1753,00036040,2448,3264,149,24
photo-3.jpg,1,1902,1933,1731,1753,12,2448,3264,31,22
photo-3.jpg,1,328,398,1756,1779,37.60,2448,3264,70,23
photo-3.jpg,1,572,627,1750,1773,3.15,2448,3264,55,23
photo-3.jpg,3,706,788,1746,1768,12 EA,2448,3264,82,22
photo-4.jpg,2,2271,2708,1665,1689,NORCO FULL CREAM MILK 3LT,2448,3264,437,24
photo-4.jpg,2,2393,2707,1626,1649,NORCO LITE MILK 2LT,2448,3264,314,23
photo-4.jpg,2,2260,2705,1586,1608,NORCO THICKENED CREAM 3LT,2448,3264,445,22
photo-4.jpg,1,358,427,1687,1708,94.50,2448,3264,69,21
photo-4.jpg,1,359,428,1648,1670,59.40,2448,3264,69,22
photo-4.jpg,1,358,443,1611,1632,100.08,2448,3264,85,21
photo-4.jpg,1,1574,1588,1670,1689,6,2448,3264,14,19
photo-4.jpg,3,731,811,1678,1700,30 EA,2448,3264,80,22
photo-4.jpg,3,731,812,1640,1663,27 EA,2448,3264,81,23
photo-4.jpg,3,731,811,1602,1624,12 EA,2448,3264,80,22
photo-4.jpg,1,599,654,1682,1702,3.15,2448,3264,55,20
photo-4.jpg,1,1732,1761,1668,1689,12,2448,3264,29,21
photo-4.jpg,1,1894,1923,1668,1688,12,2448,3264,29,20
photo-4.jpg,1,2742,2885,1667,1690,00036040,2448,3264,143,23
photo-4.jpg,1,2743,2884,1626,1649,00036127,2448,3264,141,23
photo-4.jpg,1,2741,2883,1585,1608,00300638,2448,3264,142,23
photo-4.jpg,1,1573,1588,1630,1651,9,2448,3264,15,21
photo-4.jpg,1,600,654,1643,1665,2.20,2448,3264,54,22
photo-4.jpg,1,1732,1745,1629,1650,9,2448,3264,13,21
photo-4.jpg,1,1892,1906,1628,1649,9,2448,3264,14,21
photo-4.jpg,1,1573,1587,1593,1612,6,2448,3264,14,19
photo-4.jpg,1,600,653,1606,1626,8.39,2448,3264,53,20
photo-4.jpg,1,1891,1907,1589,1610,6,2448,3264,16,21
photo-5.jpg,2,2392,2788,1590,1625,NORCO LITE MILK BTL 2LT,2448,3264,396,35
photo-5.jpg,2,2177,2785,1548,1590,RIVER1NA DAIRY NATURAL YOG 5KG TUB,2448,3264,608,42
photo-5.jpg,1,357,426,1645,1668,12.68,2448,3264,69,23
photo-5.jpg,3,739,805,1628,1651,1 EA,2448,3264,66,23
photo-5.jpg,1,603,675,1633,1658,12.68,2448,3264,72,25
photo-5.jpg,1,1940,1955,1617,1641,9,2448,3264,15,24
photo-5.jpg,1,2824,2974,1584,1612,00036127,2448,3264,150,28
photo-5.jpg,1,2822,2970,1541,1570,00813676,2448,3264,148,29
photo-5.jpg,1,1939,1950,1578,1601,1,2448,3264,11,23
photo-6.jpg,2,2273,2796,1659,1689,NORCO FULL CREAM MILK BTL 3LT,2448,3264,523,30
photo-6.jpg,2,2396,2795,1618,1645,NORCO LITE MILK BTL 2LT,2448,3264,399,27
photo-6.jpg,2,2260,2794,1575,1606,NORCO THICKENED CREAM BTL 3LT,2448,3264,534,31
photo-6.jpg,1,2834,2983,1658,1681,00036040,2448,3264,149,23
photo-6.jpg,1,2833,2982,1616,1640,00036127,2448,3264,149,24
photo-6.jpg,1,2830,2981,1573,1597,00300638,2448,3264,151,24
photo-6.jpg,1,1940,1955,1672,1692,6,2448,3264,15,20
photo-6.jpg,1,1771,1802,1673,1697,12,2448,3264,31,24
photo-6.jpg,1,337,407,1708,1730,56.70,2448,3264,70,22
photo-6.jpg,1,336,407,1669,1692,10.80,2448,3264,71,23
photo-6.jpg,1,336,407,1629,1652,83.90,2448,3264,71,23
photo-6.jpg,1,587,643,1700,1723,3.15,2448,3264,56,23
photo-6.jpg,3,724,807,1696,1720,18 EA,2448,3264,83,24
photo-6.jpg,3,723,792,1657,1680,9 EA,2448,3264,69,23
photo-6.jpg,3,723,805,1617,1641,10 EA,2448,3264,82,24
photo-6.jpg,1,1771,1786,1634,1655,9,2448,3264,15,21
photo-6.jpg,1,587,643,1662,1684,2.20,2448,3264,56,22
photo-6.jpg,1,1938,1952,1591,1612,6,2448,3264,14,21
photo-6.jpg,1,1770,1785,1594,1615,4,2448,3264,15,21
photo-6.jpg,1,586,642,1622,1644,8.39,2448,3264,56,22
photo-7.jpg,2,1284,1319,1807,2071,WHITE 680GM LOAF,2448,3264,35,264
photo-7.jpg,2,1318,1356,1748,2069,WHOLEMEAL 680G LOAF,2448,3264,38,321
photo-7.jpg,2,1354,1393,1724,2067,MULTIGRAIN 680GM LOAF,2448,3264,39,343
photo-7.jpg,2,1386,1430,1628,2066,MEDIUM WHITE KNOT UNSEEDED,2448,3264,44,438
photo-7.jpg,2,1432,1466,1813,2064,MINI LAMINGTONS,2448,3264,34,251
photo-7.jpg,3,1241,1265,947,996,FRE,2448,3264,24,49
photo-7.jpg,1,1244,1271,1016,1071,2.05,2448,3264,27,55
photo-7.jpg,1,1257,1280,1243,1260,2,2448,3264,23,17
photo-7.jpg,1,1244,1269,336,395,4.10,2448,3264,25,59
photo-7.jpg,1,1257,1282,569,626,0.00,2448,3264,25,57
photo-7.jpg,3,1277,1303,945,993,FRE,2448,3264,26,48
photo-7.jpg,1,1281,1306,1014,1068,2.05,2448,3264,25,54
photo-7.jpg,1,1294,1316,1241,1257,2,2448,3264,22,16
photo-7.jpg,1,1281,1306,334,394,4.10,2448,3264,25,60
photo-7.jpg,1,1295,1319,566,624,0.00,2448,3264,24,58
photo-7.jpg,1,1318,1343,1012,1067,2.05,2448,3264,25,55
photo-7.jpg,3,1314,1340,944,992,FRE,2448,3264,26,48
photo-7.jpg,1,1330,1353,1238,1256,2,2448,3264,23,18
photo-7.jpg,1,1317,1346,331,421,110.00,2448,3264,29,90
photo-7.jpg,1,1355,1384,328,418,110.00,2448,3264,29,90
photo-7.jpg,1,1332,1356,564,620,0.00,2448,3264,24,56
photo-7.jpg,1,1355,1380,1009,1065,0.55,2448,3264,25,56
photo-7.jpg,3,1352,1377,941,989,FRE,2448,3264,25,48
photo-7.jpg,1,1367,1392,1236,1284,200,2448,3264,25,48
photo-7.jpg,1,1368,1395,563,633,11.00,2448,3264,27,70
photo-7.jpg,1,1392,1416,1007,1063,0.55,2448,3264,24,56
photo-7.jpg,3,1388,1413,935,987,GST,2448,3264,25,52
photo-7.jpg,1,1404,1429,1235,1284,200,2448,3264,25,49
photo-8.jpg,2,1137,1166,1935,2211,WHITE 680GM LOAF,2448,3264,29,276
photo-8.jpg,2,1174,1204,1876,2210,WHOLEMEAL 680G LOAF,2448,3264,30,334
photo-8.jpg,2,1211,1242,1851,2210,MULTIGRAIN 680GM LOAF,2448,3264,31,359
photo-8.jpg,2,1248,1281,1785,2210,T HOT DOG ROLLS 'UN-SEEDED',2448,3264,33,425
photo-8.jpg,1,1126,1151,1362,1378,3,2448,3264,25,16
photo-8.jpg,1,1120,1145,1126,1182,2.05,2448,3264,25,56
photo-8.jpg,3,1118,1143,1057,1105,FRE,2448,3264,25,48
photo-8.jpg,1,1108,1132,677,737,0.00,2448,3264,24,60
photo-8.jpg,1,1100,1124,442,500,6.15,2448,3264,24,58
photo-8.jpg,1,1163,1188,1360,1378,3,2448,3264,25,18
photo-8.jpg,1,1159,1182,1124,1179,2.05,2448,3264,23,55
photo-8.jpg,3,1156,1181,1055,1103,FRE,2448,3264,25,48
photo-8.jpg,1,1138,1161,441,497,6.15,2448,3264,23,56
photo-8.jpg,1,1146,1170,676,733,0.00,2448,3264,24,57
photo-8.jpg,1,1201,1225,1359,1376,3,2448,3264,24,17
photo-8.jpg,1,1195,1220,1123,1179,2.05,2448,3264,25,56
photo-8.jpg,3,1193,1218,1053,1102,FRE,2448,3264,25,49
photo-8.jpg,1,1183,1208,673,731,0.00,2448,3264,25,58
photo-8.jpg,1,1176,1200,438,495,6.15,2448,3264,24,57
photo-8.jpg,1,1239,1265,1357,1406,200,2448,3264,26,49
photo-8.jpg,1,1233,1258,1121,1179,0.55,2448,3264,25,58
photo-8.jpg,3,1231,1256,1052,1100,FRE,2448,3264,25,48
photo-8.jpg,1,1221,1245,672,731,0.00,2448,3264,24,59
photo-8.jpg,1,1213,1238,435,525,110.00,2448,3264,25,90
photo-9.jpg,2,1178,1205,1837,2110,WHITE 680GM LOAF,2448,3264,27,273
photo-9.jpg,2,1216,1244,1777,2109,WHOLEMEAL 6806 LOAF,2448,3264,28,332
photo-9.jpg,2,1254,1283,1752,2108,MULT16RAIN 6806M LOAF,2448,3264,29,356
photo-9.jpg,2,1295,1321,1849,2108,MINI LAMINGTONS,2448,3264,26,259
photo-9.jpg,2,1332,1360,1785,2108,MINI VEGEMITE SCROLL,2448,3264,28,323
photo-9.jpg,1,1136,1163,312,371,4.10,2448,3264,27,59
photo-9.jpg,1,1148,1171,553,610,0.00,2448,3264,23,57
photo-9.jpg,3,1158,1183,945,1072,2.0S FRE,2448,3264,25,127
photo-9.jpg,1,1168,1189,1252,1269,2,2448,3264,21,17
photo-9.jpg,1,1175,1202,310,369,4.10,2448,3264,27,59
photo-9.jpg,1,1186,1210,552,609,0.00,2448,3264,24,57
photo-9.jpg,3,1196,1220,943,991,FRE,2448,3264,24,48
photo-9.jpg,1,1199,1221,1015,1070,2.05,2448,3264,22,55
photo-9.jpg,1,1206,1226,1251,1267,2,2448,3264,20,16
photo-9.jpg,1,1224,1248,550,607,0.00,2448,3264,24,57
photo-9.jpg,1,1215,1241,309,367,4.10,2448,3264,26,58
photo-9.jpg,1,1236,1260,1013,1069,2.05,2448,3264,24,56
photo-9.jpg,3,1235,1258,942,991,FRE,2448,3264,23,49
photo-9.jpg,1,1244,1265,1251,1266,2,2448,3264,21,15
photo-9.jpg,1,1252,1279,307,382,40.70,2448,3264,27,75
photo-9.jpg,1,1291,1317,306,380,40.70,2448,3264,26,74
photo-9.jpg,1,1262,1287,549,606,4.07,2448,3264,25,57
photo-9.jpg,3,1273,1296,937,990,GST,2448,3264,23,53
photo-9.jpg,1,1275,1298,1011,1069,0.55,2448,3264,23,58
photo-9.jpg,1,1282,1304,1249,1281,74,2448,3264,22,32
photo-9.jpg,1,1300,1326,547,605,4.07,2448,3264,26,58
photo-9.jpg,3,1312,1336,937,989,GST,2448,3264,24,52
photo-9.jpg,1,1314,1337,1011,1067,0.55,2448,3264,23,56
photo-9.jpg,1,1321,1342,1248,1280,74,2448,3264,21,32
photo-10.jpg,2,1192,1219,1814,2072,WHTTE 680GM LOAF,2448,3264,27,258
photo-10.jpg,2,1226,1272,1759,2086,| WHOLEMEAL 680G LOAF,2448,3264,46,327
photo-10.jpg,2,1259,1292,1736,2086,I MULTI GRAIN S80GM LOAF,2448,3264,33,350
photo-10.jpg,2,1292,1329,1643,2084,IMBXUM WHITE KNOT UNSEEDED,2448,3264,37,441
photo-10.jpg,1,1174,1195,1265,1280,3,2448,3264,21,15
photo-10.jpg,1,1165,1189,1040,1093,2.05,2448,3264,24,53
photo-10.jpg,3,1164,1186,973,1019,FRE,2448,3264,22,46
photo-10.jpg,3,1150,1173,606,662,aoo,2448,3264,23,56
photo-10.jpg,1,1176,1200,377,432,605,2448,3264,24,55
photo-10.jpg,1,1209,1231,1263,1278,3,2448,3264,22,15
photo-10.jpg,1,1202,1225,1039,1090,2.05,2448,3264,23,51
photo-10.jpg,3,1200,1222,973,1017,FRE,2448,3264,22,44
photo-10.jpg,3,1185,1208,604,660,aoo,2448,3264,23,56
photo-10.jpg,1,1213,1236,375,429,6.15,2448,3264,23,54
photo-10.jpg,1,1246,1267,1263,1278,3,2448,3264,21,15
photo-10.jpg,1,1238,1260,1037,1090,2.05,2448,3264,22,53
photo-10.jpg,3,1236,1258,971,1016,FRE,2448,3264,22,45
photo-10.jpg,3,1222,1245,602,657,aoo,2448,3264,23,55
photo-10.jpg,3,1249,1273,371,457,naco,2448,3264,24,86
photo-10.jpg,1,1282,1304,1261,1307,200,2448,3264,22,46
photo-10.jpg,3,1274,1297,1036,1090,ass,2448,3264,23,54
photo-10.jpg,3,1272,1294,969,1015,FRE,2448,3264,22,46
photo-10.jpg,3,1258,1281,600,656,aoo,2448,3264,23,56
photo-11.jpg,2,1163,1191,1858,2117,WHITE 680GM LOAF,2448,3264,28,259
photo-11.jpg,2,1199,1228,1802,2118,WHOLEMEAL 680G LOAF,2448,3264,29,316
photo-11.jpg,2,1235,1264,1778,2117,MULTIGRAIN 680GM LOAF,2448,3264,29,339
photo-11.jpg,2,1272,1300,1811,2116,MINI VEGEMITE SCROLL,2448,3264,28,305
photo-11.jpg,1,1142,1165,1058,1113,2.05,2448,3264,23,55
photo-11.jpg,3,1140,1163,989,1038,FRE,2448,3264,23,49
photo-11.jpg,1,1149,1171,1289,1306,3,2448,3264,22,17
photo-11.jpg,1,1127,1150,610,666,0.00,2448,3264,23,56
photo-11.jpg,1,1119,1142,374,431,6.15,2448,3264,23,57
photo-11.jpg,1,1179,1202,1057,1111,2.05,2448,3264,23,54
photo-11.jpg,3,1177,1200,988,1037,FRE,2448,3264,23,49
photo-11.jpg,1,1186,1208,1288,1305,3,2448,3264,22,17
photo-11.jpg,1,1165,1187,609,664,0.00,2448,3264,22,55
photo-11.jpg,1,1156,1179,373,430,6.15,2448,3264,23,57
photo-11.jpg,1,1216,1239,1056,1111,2.05,2448,3264,23,55
photo-11.jpg,3,1214,1236,989,1036,FRE,2448,3264,22,47
photo-11.jpg,1,1223,1244,1287,1305,3,2448,3264,21,18
photo-11.jpg,1,1201,1225,607,663,0.00,2448,3264,24,56
photo-11.jpg,1,1194,1217,372,428,6.15,2448,3264,23,56
photo-11.jpg,1,1253,1276,1055,1111,055,2448,3264,23,56
photo-11.jpg,3,1251,1274,983,1036,GST,2448,3264,23,53
photo-11.jpg,3,1258,1282,1286,1333,ISO,2448,3264,24,47
photo-11.jpg,1,1238,1261,607,662,8.25,2448,3264,23,55
photo-11.jpg,1,1231,1255,370,444,82.50,2448,3264,24,74
photo-13.jpg,2,1154,1181,1969,2242,WHITE 680GM LOAF,2448,3264,27,273
photo-13.jpg,2,1192,1219,1910,2242,WHOLEMEAL 6806 LOAF,2448,3264,27,332
photo-13.jpg,2,1230,1257,1886,2239,MULTIGRAIN 6806M LOAF,2448,3264,27,353
photo-13.jpg,1,1125,1150,431,492,4.10,2448,3264,25,61
photo-13.jpg,1,1131,1155,674,733,0.00,2448,3264,24,59
photo-13.jpg,1,1141,1165,1136,1194,2.05,2448,3264,24,58
photo-13.jpg,3,1139,1163,1066,1115,FRE,2448,3264,24,49
photo-13.jpg,1,1145,1168,1375,1393,2,2448,3264,23,18
photo-13.jpg,1,1162,1188,432,491,4.10,2448,3264,26,59
photo-13.jpg,1,1170,1195,674,732,0.00,2448,3264,25,58
photo-13.jpg,1,1184,1206,1375,1392,2,2448,3264,22,17
photo-13.jpg,1,1180,1203,1136,1191,2.05,2448,3264,23,55
photo-13.jpg,3,1178,1201,1066,1114,FRE,2448,3264,23,48
photo-13.jpg,1,1201,1226,430,490,4.10,2448,3264,25,60
photo-13.jpg,1,1208,1233,673,730,0.00,2448,3264,25,57
photo-13.jpg,1,1221,1245,1375,1391,2,2448,3264,24,16
photo-13.jpg,1,1218,1242,1134,1192,2.05,2448,3264,24,58
photo-13.jpg,3,1216,1239,1065,1113,FRE,2448,3264,23,48
photo-14.jpg,2,1212,1239,1955,2224,WHITE 680GM LOAF,3264,2448,27,269
photo-14.jpg,2,1251,1276,1897,2224,WHOLEMEAL 680G LOAF,3264,2448,25,327
photo-14.jpg,2,1288,1314,1874,2224,MULTIGRAIN 680GM LOAF,3264,2448,26,350
photo-14.jpg,2,1326,1352,1780,2223,MEDIUM WHITE KNOT UNSEEDED,3264,2448,26,443
photo-14.jpg,2,1364,1389,1969,2223,MINI LAMINGTONS,3264,2448,25,254
photo-14.jpg,3,1168,1182,66,79,i,3264,2448,14,13
photo-14.jpg,1,1218,1241,1376,1392,3,3264,2448,23,16
photo-14.jpg,1,1219,1241,1145,1197,2.05,3264,2448,22,52
photo-14.jpg,3,1218,1242,1077,1123,FRE,3264,2448,24,46
photo-14.jpg,1,1217,1240,467,522,6.15,3264,2448,23,55
photo-14.jpg,1,1219,1242,697,753,0.00,3264,2448,23,56
photo-14.jpg,1,1255,1279,1376,1392,3,3264,2448,24,16
photo-14.jpg,1,1255,1278,466,521,6.15,3264,2448,23,55
photo-14.jpg,1,1255,1279,1143,1197,2.05,3264,2448,24,54
photo-14.jpg,3,1256,1279,1077,1123,FRE,3264,2448,23,46
photo-14.jpg,1,1256,1279,697,753,0.00,3264,2448,23,56
photo-14.jpg,1,1292,1316,1376,1391,3,3264,2448,24,15
photo-14.jpg,1,1293,1316,1143,1197,2.50,3264,2448,23,54
photo-14.jpg,3,1293,1317,1077,1122,FRE,3264,2448,24,45
photo-14.jpg,1,1292,1316,697,753,0.00,3264,2448,24,56
photo-14.jpg,1,1292,1315,467,521,7.50,3264,2448,23,54
photo-14.jpg,1,1330,1354,1374,1422,150,3264,2448,24,48
photo-14.jpg,1,1330,1354,1142,1197,0.55,3264,2448,24,55
photo-14.jpg,3,1330,1354,1076,1123,FRE,3264,2448,24,47
photo-14.jpg,1,1329,1353,464,535,82.50,3264,2448,24,71
photo-14.jpg,1,1367,1391,463,535,82.50,3264,2448,24,72
photo-14.jpg,1,1331,1354,695,751,0.00,3264,2448,23,56
photo-14.jpg,1,1368,1392,1375,1421,150,3264,2448,24,46
photo-14.jpg,1,1368,1392,1141,1197,0.55,3264,2448,24,56
photo-14.jpg,3,1368,1392,1072,1123,GST,3264,2448,24,51
photo-14.jpg,1,1368,1391,696,750,8.25,3264,2448,23,54
photo-15.jpg,2,1211,1236,1926,2208,WHITE 680GM LOAF,3264,2448,25,282
photo-15.jpg,2,1251,1276,1865,2207,WHOLEMEAL 6806 LOAF,3264,2448,25,342
photo-15.jpg,2,1291,1316,1839,2206,MULTIGRAIN 6806M LOAF,3264,2448,25,367
photo-15.jpg,1,1212,1234,1330,1346,2,3264,2448,22,16
photo-15.jpg,1,1211,1235,1087,1144,205,3264,2448,24,57
photo-15.jpg,3,1211,1235,1016,1064,FRE,3264,2448,24,48
photo-15.jpg,1,1210,1234,624,680,0.00,3264,2448,24,56
photo-15.jpg,3,1207,1234,381,438,"4,10",3264,2448,27,57
photo-15.jpg,1,1252,1274,1327,1346,2,3264,2448,22,19
photo-15.jpg,3,1251,1274,1087,1143,Z05,3264,2448,23,56
photo-15.jpg,3,1249,1275,1015,1064,FRE,3264,2448,26,49
photo-15.jpg,1,1247,1271,380,438,4.10,3264,2448,24,58
photo-15.jpg,1,1249,1273,622,680,0.00,3264,2448,24,58
photo-15.jpg,3,1290,1313,1087,1143,Z05,3264,2448,23,56
photo-15.jpg,3,1286,1312,380,437,"4,10",3264,2448,26,57
photo-15.jpg,1,1292,1314,1328,1345,2,3264,2448,22,17
photo-15.jpg,3,1289,1314,1016,1063,FRE,3264,2448,25,47
photo-15.jpg,3,1288,1312,622,680,"0,00",3264,2448,24,58
photo-16.jpg,2,2066,2681,1377,1411,CARROT CAULIFLOWER BROCCOLI & BEANS,3264,2448,615,34
photo-16.jpg,2,2270,2676,1259,1291,CHEESE BLUE VEIN WEDGES,3264,2448,406,32
photo-16.jpg,2,2480,2676,1219,1246,CHEESE BRIE,3264,2448,196,27
photo-16.jpg,2,2389,2675,1180,1211,CHEESE CAMEMBERT,3264,2448,286,31
photo-16.jpg,2,2303,2674,1141,1173,CHEESE COBRAM VINTAGE,3264,2448,371,32
photo-16.jpg,2,2458,2673,1102,1130,CHEESE GOUDA,3264,2448,215,28
photo-16.jpg,2,2388,2672,1062,1094,DIP FRENCH ONION,3264,2448,284,32
photo-16.jpg,2,2284,2672,1023,1059,DIP HOMMUS TRADITIONAL,3264,2448,388,36
photo-16.jpg,1,227,307,1409,1433,46.08,3264,2448,80,24
photo-16.jpg,3,1395,1460,1401,1423,2 KG,3264,2448,65,22
photo-16.jpg,1,1034,1049,1405,1427,6,3264,2448,15,22
photo-16.jpg,1,872,934,1406,1429,7.68,3264,2448,62,23
photo-16.jpg,1,723,786,1408,1430,7.68,3264,2448,63,22
photo-16.jpg,1,558,639,1409,1431,46.08,3264,2448,81,22
photo-16.jpg,1,2738,2825,1372,1399,30845,3264,2448,87,27
photo-16.jpg,3,1263,1309,1403,1421,PKT,3264,2448,46,18
photo-16.jpg,3,1678,1777,1396,1416,MCCAIN,3264,2448,99,20
photo-16.jpg,1,227,308,1297,1321,12.56,3264,2448,81,24
photo-16.jpg,3,1361,1459,1286,1311,100 GR,3264,2448,98,25
photo-16.jpg,3,1361,1460,1250,1273,125 GR,3264,2448,99,23
photo-16.jpg,3,1361,1459,1210,1236,125 GR,3264,2448,98,26
photo-16.jpg,3,1362,1459,1174,1196,250 GR,3264,2448,97,22
photo-16.jpg,3,1361,1459,1136,1160,250 GR,3264,2448,98,24
photo-16.jpg,3,1361,1458,1098,1122,185 GR,3264,2448,97,24
photo-16.jpg,3,1361,1458,1061,1084,200 GR,3264,2448,97,23
photo-16.jpg,1,558,640,1296,1319,12.56,3264,2448,82,23
photo-16.jpg,1,871,935,1293,1315,3.14,3264,2448,64,22
photo-16.jpg,1,723,786,1294,1317,3.14,3264,2448,63,23
photo-16.jpg,1,1035,1050,1294,1314,4,3264,2448,15,20
photo-16.jpg,1,2714,2822,1254,1282,109530,3264,2448,108,28
photo-16.jpg,1,2714,2820,1215,1242,109449,3264,2448,106,27
photo-16.jpg,1,2730,2819,1173,1202,12681,3264,2448,89,29
photo-16.jpg,1,2747,2819,1136,1162,6847,3264,2448,72,26
photo-16.jpg,1,2747,2816,1096,1123,3057,3264,2448,69,27
photo-16.jpg,1,2710,2818,1056,1085,134768,3264,2448,108,29
photo-16.jpg,1,2709,2817,1018,1045,130359,3264,2448,108,27
photo-16.jpg,3,1261,1310,1289,1309,PKT,3264,2448,49,20
photo-16.jpg,3,1643,1777,1281,1303,MAINLAND,3264,2448,134,22
photo-16.jpg,3,1643,1774,1244,1266,PRESTIGE,3264,2448,131,22
photo-16.jpg,3,1643,1774,1204,1228,PRESTIGE,3264,2448,131,24
photo-16.jpg,3,1626,1775,1167,1189,DEVONDALE,3264,2448,149,22
photo-16.jpg,3,1642,1774,1129,1151,MAINLAND,3264,2448,132,22
photo-16.jpg,3,1690,1772,1092,1112,KRAFT,3264,2448,82,20
photo-16.jpg,3,1692,1773,1053,1075,CHRIS,3264,2448,81,22
photo-16.jpg,1,559,623,1259,1282,8.56,3264,2448,64,23
photo-16.jpg,1,227,291,1260,1283,8.56,3264,2448,64,23
photo-16.jpg,1,872,934,1257,1278,2.14,3264,2448,62,21
photo-16.jpg,1,723,786,1257,1281,2.14,3264,2448,63,24
photo-16.jpg,1,1035,1049,1255,1277,4,3264,2448,14,22
photo-16.jpg,3,1261,1309,1253,1272,PKT,3264,2448,48,19
photo-16.jpg,3,227,291,1220,1246,8.S6,3264,2448,64,26
photo-16.jpg,1,873,935,1219,1242,2.14,3264,2448,62,23
photo-16.jpg,1,724,787,1220,1243,2.14,3264,2448,63,23
photo-16.jpg,1,559,623,1221,1245,8.56,3264,2448,64,24
photo-16.jpg,1,1035,1049,1217,1239,4,3264,2448,14,22
photo-16.jpg,3,1262,1309,1213,1234,PKT,3264,2448,47,21
photo-16.jpg,1,228,308,1184,1207,11.52,3264,2448,80,23
photo-16.jpg,1,226,309,1146,1172,17.56,3264,2448,83,26
photo-16.jpg,1,724,786,1182,1205,5.76,3264,2448,62,23
photo-16.jpg,1,1036,1049,1180,1202,2,3264,2448,13,22
photo-16.jpg,1,873,935,1181,1204,5.76,3264,2448,62,23
photo-16.jpg,1,561,640,1184,1206,11.52,3264,2448,79,22
photo-16.jpg,1,559,641,1146,1170,17.56,3264,2448,82,24
photo-16.jpg,1,559,624,1110,1133,6.27,3264,2448,65,23
photo-16.jpg,1,559,624,1072,1094,4.86,3264,2448,65,22
photo-16.jpg,3,1263,1309,1176,1196,PKT,3264,2448,46,20
photo-16.jpg,1,872,936,1145,1167,4.39,3264,2448,64,22
photo-16.jpg,1,724,788,1146,1169,4.39,3264,2448,64,23
photo-16.jpg,1,1035,1050,1143,1165,4,3264,2448,15,22
photo-16.jpg,3,1262,1310,1139,1158,PKT,3264,2448,48,19
photo-16.jpg,1,724,787,1108,1131,2.09,3264,2448,63,23
photo-16.jpg,1,227,291,1110,1134,6.27,3264,2448,64,24
photo-16.jpg,1,1036,1048,1105,1128,3,3264,2448,12,23
photo-16.jpg,1,872,935,1107,1129,2.09,3264,2448,63,22
photo-16.jpg,3,1263,1311,1102,1121,TUB,3264,2448,48,19
photo-16.jpg,1,1036,1048,1069,1090,2,3264,2448,12,21
photo-16.jpg,1,873,935,1070,1092,2.43,3264,2448,62,22
photo-16.jpg,1,725,788,1071,1094,2.43,3264,2448,63,23
photo-16.jpg,1,227,291,1072,1095,4.86,3264,2448,64,23
photo-16.jpg,3,1263,1310,1064,1084,TUB,3264,2448,47,20
photo-17.jpg,2,2430,2693,1430,1458,GARLIC BREAD 7,3264,2448,263,28
photo-17.jpg,2,2359,2693,1390,1421,TORTILLAS FLOUR 12”,3264,2448,334,31
photo-17.jpg,2,2184,2692,1353,1382,TORTILLAS FLOUR 12” WHOLEMEAL,3264,2448,508,29
photo-17.jpg,2,2219,2691,1313,1345,TORTILLAS FLOUR SPINACH 12,3264,2448,472,32
photo-17.jpg,2,1949,2686,1194,1235,SAUSAGES 8BQ THIN GAS FLUSHED (APP 5 KG CTN),3264,2448,737,41
photo-17.jpg,2,2212,2686,1117,1149,YOGHURT GREEK NATURAL SWEET,3264,2448,474,32
photo-17.jpg,2,2076,2682,1000,1040,LABELS REMOVABLE 40MM SQUARE FRIDAY,3264,2448,606,40
photo-17.jpg,2,2075,2682,961,1000,LABELS REMOVABLE 40MM SQUARE MONDAY,3264,2448,607,39
photo-17.jpg,2,2041,2681,923,966,LABELS REMOVABLE 40MM SQUARE THURSDAY,3264,2448,640,43
photo-17.jpg,2,2056,2826,873,927,66847 _LABELS REMOVABLE 40MM SQUARE TUESDAY,3264,2448,770,54
photo-17.jpg,2,2023,2680,845,890,LABELS REMOVABLE 40MM SQUARE WEDNESDAY,3264,2448,657,45
photo-17.jpg,1,258,335,1463,1487,34.55,3264,2448,77,24
photo-17.jpg,1,256,334,1425,1450,12.72,3264,2448,78,25
photo-17.jpg,1,255,319,1389,1411,4.24,3264,2448,64,22
photo-17.jpg,1,589,668,1458,1484,34.55,3264,2448,79,26
photo-17.jpg,1,588,667,1420,1446,12.72,3264,2448,79,26
photo-17.jpg,1,586,652,1384,1408,4.24,3264,2448,66,24
photo-17.jpg,3,1423,1487,1448,1472,48‘S,3264,2448,64,24
photo-17.jpg,1,1063,1079,1452,1475,1,3264,2448,16,23
photo-17.jpg,1,902,979,1453,1478,34.55,3264,2448,77,25
photo-17.jpg,1,900,964,1416,1440,4.24,3264,2448,64,24
photo-17.jpg,1,900,965,1379,1402,4.24,3264,2448,65,23
photo-17.jpg,1,899,962,1340,1365,5.27,3264,2448,63,25
photo-17.jpg,1,754,832,1456,1479,34.55,3264,2448,78,23
photo-17.jpg,3,1634,1799,1443,1466,LAFAMIGLIA,3264,2448,165,23
photo-17.jpg,3,1601,1799,1405,1428,CATERERS CHO,3264,2448,198,23
photo-17.jpg,3,1601,1799,1367,1390,CATERERS CHO,3264,2448,198,23
photo-17.jpg,3,1600,1798,1329,1353,MISSION FOOD,3264,2448,198,24
photo-17.jpg,3,1293,1339,1449,1470,CTN,3264,2448,46,21
photo-17.jpg,1,2748,2837,1427,1452,31637,3264,2448,89,25
photo-17.jpg,1,2729,2837,1387,1412,156647,3264,2448,108,25
photo-17.jpg,1,2728,2836,1349,1374,156648,3264,2448,108,25
photo-17.jpg,1,2729,2835,1309,1335,109722,3264,2448,106,26
photo-17.jpg,3,1421,1485,1410,1434,12’S,3264,2448,64,24
photo-17.jpg,1,1064,1077,1415,1438,3,3264,2448,13,23
photo-17.jpg,1,753,816,1419,1441,4.24,3264,2448,63,22
photo-17.jpg,3,1290,1337,1412,1432,PICT,3264,2448,47,20
photo-17.jpg,3,1421,1485,1373,1396,12 'S,3264,2448,64,23
photo-17.jpg,1,752,816,1381,1404,4.24,3264,2448,64,23
photo-17.jpg,1,1062,1078,1377,1399,1,3264,2448,16,22
photo-17.jpg,3,1290,1337,1375,1394,PICT,3264,2448,47,19
photo-17.jpg,1,253,315,1351,1375,5.27,3264,2448,62,24
photo-17.jpg,1,585,649,1346,1370,5.27,3264,2448,64,24
photo-17.jpg,1,751,813,1344,1368,5.27,3264,2448,62,24
photo-17.jpg,3,1421,1484,1336,1359,12'S,3264,2448,63,23
photo-17.jpg,3,1061,1095,1340,1363,• 1,3264,2448,34,23
photo-17.jpg,3,1289,1336,1337,1357,PICT,3264,2448,47,20
photo-17.jpg,3,3151,3202,1213,1234,an,3264,2448,51,21
photo-17.jpg,1,253,332,1238,1263,26.15,3264,2448,79,25
photo-17.jpg,1,585,665,1233,1259,26.15,3264,2448,80,26
photo-17.jpg,1,899,961,1228,1254,5.23,3264,2448,62,26
photo-17.jpg,1,750,812,1230,1256,5.23,3264,2448,62,26
photo-17.jpg,1,1061,1075,1226,1250,5,3264,2448,14,24
photo-17.jpg,3,1304,1335,1223,1244,KG,3264,2448,31,21
photo-17.jpg,1,2726,2832,1190,1217,114982,3264,2448,106,27
photo-17.jpg,3,1450,1483,1221,1241,KG,3264,2448,33,20
photo-17.jpg,1,249,329,1162,1188,34.20,3264,2448,80,26
photo-17.jpg,1,583,663,1160,1184,34.20,3264,2448,80,24
photo-17.jpg,1,748,827,1157,1180,34.20,3264,2448,79,23
photo-17.jpg,1,896,976,1155,1179,34.20,3264,2448,80,24
photo-17.jpg,1,1058,1075,1154,1175,1,3264,2448,17,21
photo-17.jpg,3,1400,1482,1147,1168,10 KG,3264,2448,82,21
photo-17.jpg,3,1286,1334,1150,1169,BKT,3264,2448,48,19
photo-17.jpg,1,2724,2830,1113,1138,122955,3264,2448,106,25
photo-17.jpg,1,429,496,1050,1073,0.96,3264,2448,67,23
photo-17.jpg,1,248,328,1052,1075,10.54,3264,2448,80,23
photo-17.jpg,1,248,327,1014,1039,10.54,3264,2448,79,25
photo-17.jpg,1,246,326,977,1001,10.54,3264,2448,80,24
photo-17.jpg,1,246,327,940,964,10.54,3264,2448,81,24
photo-17.jpg,1,246,326,903,927,10.54,3264,2448,80,24
photo-17.jpg,1,581,646,1047,1072,9.58,3264,2448,65,25
photo-17.jpg,1,746,809,1046,1070,9.58,3264,2448,63,24
photo-17.jpg,1,1057,1072,1042,1064,1,3264,2448,15,22
photo-17.jpg,1,894,958,1043,1067,9.58,3264,2448,64,24
photo-17.jpg,3,1399,1479,1034,1057,500'S,3264,2448,80,23
photo-17.jpg,3,1399,1479,997,1020,500'S,3264,2448,80,23
photo-17.jpg,3,1398,1477,959,983,500’S,3264,2448,79,24
photo-17.jpg,3,1397,1478,923,946,500'S,3264,2448,81,23
photo-17.jpg,3,1397,1477,885,909,500'S,3264,2448,80,24
photo-17.jpg,3,1300,1331,1037,1056,EA,3264,2448,31,19
photo-17.jpg,1,2739,2828,996,1021,66850,3264,2448,89,25
photo-17.jpg,1,2739,2827,957,983,66846,3264,2448,88,26
photo-17.jpg,1,2738,2827,918,944,66849,3264,2448,89,26
photo-17.jpg,1,2736,2825,840,866,66848,3264,2448,89,26
photo-17.jpg,3,1693,1793,1027,1048,DAYDOT,3264,2448,100,21
photo-17.jpg,3,1692,1793,989,1010,DAYDOT,3264,2448,101,21
photo-17.jpg,3,1692,1791,952,974,DAYDOT,3264,2448,99,22
photo-17.jpg,3,1691,1791,915,937,DAYDOT,3264,2448,100,22
photo-17.jpg,3,1691,1790,877,899,DAYDOT,3264,2448,99,22
photo-17.jpg,1,428,495,1012,1037,0.96,3264,2448,67,25
photo-17.jpg,1,428,494,975,999,0.96,3264,2448,66,24
photo-17.jpg,1,580,646,1011,1035,958,3264,2448,66,24
photo-17.jpg,1,745,809,1009,1032,9.58,3264,2448,64,23
photo-17.jpg,1,893,958,1008,1031,9.58,3264,2448,65,23
photo-17.jpg,1,1056,1071,1006,1027,1,3264,2448,15,21
photo-17.jpg,3,1299,1331,1000,1018,EA,3264,2448,32,18
photo-17.jpg,1,579,645,973,999,9.58,3264,2448,66,26
photo-17.jpg,1,745,809,972,996,9.58,3264,2448,64,24
photo-17.jpg,1,893,957,970,993,9.58,3264,2448,64,23
photo-17.jpg,1,1055,1071,967,990,1,3264,2448,16,23
photo-17.jpg,3,1300,1331,963,982,EA,3264,2448,31,19
photo-17.jpg,3,421,515,929,968,.JL?6j,3264,2448,94,39
photo-17.jpg,3,743,974,926,960,.9.58 _ _9i58,3264,2448,231,34
photo-17.jpg,3,1298,1331,926,945,EA,3264,2448,33,19
photo-17.jpg,1,428,493,900,925,0.96,3264,2448,65,25
photo-17.jpg,1,578,643,900,924,9.58,3264,2448,65,24
photo-17.jpg,1,743,806,898,921,9.58,3264,2448,63,23
photo-17.jpg,1,893,956,896,919,9.58,3264,2448,63,23
photo-17.jpg,1,1055,1070,894,914,1,3264,2448,15,20
photo-17.jpg,3,1298,1329,889,907,EA,3264,2448,31,18
photo-19.jpg,2,2316,2719,1389,1415,PIES VEGETABLE SUPREME,3264,2448,403,26
photo-19.jpg,2,2278,2718,1264,1297,CUPS PLASTIC WHITE 180ML,3264,2448,440,33
photo-19.jpg,1,178,264,1431,1454,48.84,3264,2448,86,23
photo-19.jpg,1,369,436,1428,1450,4.44,3264,2448,67,22
photo-19.jpg,1,522,608,1424,1448,44.40,3264,2448,86,24
photo-19.jpg,1,1021,1036,1417,1440,2,3264,2448,15,23
photo-19.jpg,1,850,934,1419,1443,22.20,3264,2448,84,24
photo-19.jpg,3,1325,1462,1409,1434,12 X 200,3264,2448,137,25
photo-19.jpg,1,694,779,1422,1446,22.20,3264,2448,85,24
photo-19.jpg,1,2761,2873,1384,1411,154859,3264,2448,112,27
photo-19.jpg,3,1651,1787,1404,1427,MRS MACS,3264,2448,136,23
photo-19.jpg,3,1258,1308,1413,1433,CTN,3264,2448,50,20
photo-19.jpg,1,2759,2870,1260,1287,107035,3264,2448,111,27
photo-19.jpg,1,175,260,1312,1337,28.60,3264,2448,85,25
photo-19.jpg,1,365,433,1308,1334,2.60,3264,2448,68,26
photo-19.jpg,1,520,604,1306,1332,26.00,3264,2448,84,26
photo-19.jpg,1,1017,1049,1299,1322,20,3264,2448,32,23
photo-19.jpg,1,847,914,1301,1325,1.30,3264,2448,67,24
photo-19.jpg,1,692,759,1304,1329,1.30,3264,2448,67,25
photo-19.jpg,3,1392,1457,1290,1316,50'S,3264,2448,65,26
photo-19.jpg,3,1254,1304,1294,1315,SLV,3264,2448,50,21
photo-19.jpg,3,1596,1784,1285,1309,FOODSERVICE,3264,2448,188,24
photo-20.jpg,2,2515,2753,1354,1377,COOKIES ANZAC,3264,2448,238,23
photo-20.jpg,2,2262,2750,1234,1263,YOGHURT GREEK NATURAL SWEET,3264,2448,488,29
photo-20.jpg,2,2174,2923,1102,1149,' .3293..BISCUITS P/C 195. TIM TAM S/SERVE,3264,2448,749,47
photo-20.jpg,2,1985,2747,1073,1111,BISCUITS P/C 204 CRM CHOCOLATE / SHORTBREAD,3264,2448,762,38
photo-20.jpg,2,1949,2746,991,1032,BISCUITS P/C 403 CHOC RIPPLE & BUTTERNUT SNAP,3264,2448,797,41
photo-20.jpg,2,2313,2746,951,985,CLINGWRAP DISPENSER 45CM,3264,2448,433,34
photo-20.jpg,1,259,339,1387,1413,90.24,3264,2448,80,26
photo-20.jpg,1,594,675,1382,1407,82.04,3264,2448,81,25
photo-20.jpg,1,442,507,1384,1408,8.20,3264,2448,65,24
photo-20.jpg,1,762,843,1380,1403,41.02,3264,2448,81,23
photo-20.jpg,1,2810,2899,1354,1378,56935,3264,2448,89,24
photo-20.jpg,3,1380,1513,1369,1394,125 X 40,3264,2448,133,25
photo-20.jpg,1,913,995,1376,1402,41.02,3264,2448,82,26
photo-20.jpg,1,1080,1095,1375,1398,2,3264,2448,15,23
photo-20.jpg,3,1733,1833,1365,1387,BAKELS,3264,2448,100,22
photo-20.jpg,3,1313,1362,1372,1393,CTN,3264,2448,49,21
photo-20.jpg,1,2790,2898,1233,1258,122955,3264,2448,108,25
photo-20.jpg,1,255,335,1274,1299,34.20,3264,2448,80,25
photo-20.jpg,1,590,673,1268,1293,34.20,3264,2448,83,25
photo-20.jpg,1,909,992,1261,1288,34.20,3264,2448,83,27
photo-20.jpg,1,759,840,1265,1290,34.20,3264,2448,81,25
photo-20.jpg,3,1429,1511,1254,1279,10 KG,3264,2448,82,25
photo-20.jpg,1,1076,1094,1261,1284,1,3264,2448,18,23
photo-20.jpg,3,1311,1359,1257,1278,BKT,3264,2448,48,21
photo-20.jpg,1,251,333,1156,1183,92.40,3264,2448,82,27
photo-20.jpg,1,251,331,1118,1144,39.22,3264,2448,80,26
photo-20.jpg,1,588,672,1153,1177,84.00,3264,2448,84,24
photo-20.jpg,1,589,670,1114,1138,35.65,3264,2448,81,24
photo-20.jpg,1,435,502,1155,1179,8.40,3264,2448,67,24
photo-20.jpg,1,908,991,1146,1172,42.00,3264,2448,83,26
photo-20.jpg,1,909,988,1107,1134,35.65,3264,2448,79,27
photo-20.jpg,1,757,841,1150,1174,42.00,3264,2448,84,24
photo-20.jpg,1,758,838,1111,1136,35.65,3264,2448,80,25
photo-20.jpg,3,1376,1509,1138,1163,150 X 18,3264,2448,133,25
photo-20.jpg,3,1376,1508,1100,1125,150 X 32,3264,2448,132,25
photo-20.jpg,1,1076,1090,1144,1168,2,3264,2448,14,24
photo-20.jpg,3,1712,1831,1132,1154,ARNOTTS,3264,2448,119,22
photo-20.jpg,3,1712,1830,1093,1116,ARNOTTS,3264,2448,118,23
photo-20.jpg,3,1309,1358,1140,1161,CTN,3264,2448,49,21
photo-20.jpg,1,436,500,1115,1140,3.57,3264,2448,64,25
photo-20.jpg,1,2822,2895,1070,1094,3710,3264,2448,73,24
photo-20.jpg,1,1075,1089,1107,1128,1,3264,2448,14,21
photo-20.jpg,3,1309,1358,1102,1124,CTN,3264,2448,49,22
photo-20.jpg,1,248,330,1040,1068,37.26,3264,2448,82,28
photo-20.jpg,1,249,331,1002,1029,23.00,3264,2448,82,27
photo-20.jpg,1,589,669,1037,1061,33.87,3264,2448,80,24
photo-20.jpg,1,587,670,999,1024,20.91,3264,2448,83,25
photo-20.jpg,1,434,500,1038,1063,3.39,3264,2448,66,25
photo-20.jpg,3,1375,1508,1021,1047,150 X 21,3264,2448,133,26
photo-20.jpg,3,1373,1508,978,1009,600M X. 4,3264,2448,135,31
photo-20.jpg,1,907,987,1030,1057,33.87,3264,2448,80,27
photo-20.jpg,3,906,988,987,1020,"20,91",3264,2448,82,33
photo-20.jpg,1,756,837,1033,1059,33.87,3264,2448,81,26
photo-20.jpg,1,756,838,996,1021,20.91,3264,2448,82,25
photo-20.jpg,1,1072,1089,1030,1052,1,3264,2448,17,22
photo-20.jpg,1,2805,2895,988,1014,88972,3264,2448,90,26
photo-20.jpg,3,1712,1830,1014,1038,ARNOTTS,3264,2448,118,24
photo-20.jpg,3,1692,1829,977,998,CASTAWAY,3264,2448,137,21
photo-20.jpg,3,1309,1357,1025,1046,CTN,3264,2448,48,21
photo-20.jpg,3,3214,3223,976,1004,I,3264,2448,9,28
photo-20.jpg,3,436,510,985,1025,",?^09",3264,2448,74,40
photo-20.jpg,1,1073,1089,991,1014,1,3264,2448,16,23
photo-20.jpg,1,2824,2894,947,973,2793,3264,2448,70,26
photo-20.jpg,3,1290,1357,987,1008,ROLL,3264,2448,67,21
photo-21.jpg,2,2540,2764,1336,1363,BROCCOLI IQF,3264,2448,224,27
photo-21.jpg,2,2558,2765,1297,1321,CAULIFLOWER,3264,2448,207,24
photo-21.jpg,2,2266,2764,1256,1285,VEGETABLES SPECIALTY MEDLEY,3264,2448,498,29
photo-21.jpg,1,2841,2915,1337,1362,2926,3264,2448,74,25
photo-21.jpg,1,2821,2913,1255,1280,54464,3264,2448,92,25
photo-21.jpg,1,200,283,1361,1386,54.96,3264,2448,83,25
photo-21.jpg,1,199,283,1322,1348,50.28,3264,2448,84,26
photo-21.jpg,1,198,282,1283,1308,51.60,3264,2448,84,25
photo-21.jpg,1,551,635,1359,1384,54.96,3264,2448,84,25
photo-21.jpg,1,549,635,1319,1346,50.28,3264,2448,86,27
photo-21.jpg,1,549,634,1280,1305,51.60,3264,2448,85,25
photo-21.jpg,3,1395,1497,1350,1374,1.5 KG,3264,2448,102,24
photo-21.jpg,3,1429,1497,1311,1336,2 KG,3264,2448,68,25
photo-21.jpg,3,1394,1495,1271,1296,6x1 KG,3264,2448,101,25
photo-21.jpg,1,1052,1068,1355,1379,6,3264,2448,16,24
photo-21.jpg,1,881,949,1353,1379,9.16,3264,2448,68,26
photo-21.jpg,1,726,793,1356,1382,9.16,3264,2448,67,26
photo-21.jpg,3,1292,1341,1352,1374,PKT,3264,2448,49,22
photo-21.jpg,3,1722,1824,1348,1370,EDGELL,3264,2448,102,22
photo-21.jpg,3,1722,1824,1308,1330,EDGELL,3264,2448,102,22
photo-21.jpg,3,1722,1822,1269,1291,FINDUS,3264,2448,100,22
photo-21.jpg,1,881,948,1315,1340,8.38,3264,2448,67,25
photo-21.jpg,1,1051,1068,1316,1339,6,3264,2448,17,23
photo-21.jpg,1,725,792,1316,1343,8.38,3264,2448,67,27
photo-21.jpg,3,1291,1340,1313,1334,PKT,3264,2448,49,21
photo-21.jpg,1,2862,2913,1296,1320,305,3264,2448,51,24
photo-21.jpg,1,879,963,1275,1302,25.80,3264,2448,84,27
photo-21.jpg,1,723,808,1277,1303,25.80,3264,2448,85,26
photo-21.jpg,1,1052,1067,1276,1300,2,3264,2448,15,24
photo-21.jpg,3,1291,1341,1273,1295,CTN,3264,2448,50,22
photo-22.jpg,2,2191,2729,1340,1371,ARTICHOKES MARINATED QUARTERED,3264,2448,538,31
photo-22.jpg,2,2527,2726,1300,1335,BAKED BiANS,3264,2448,199,35
photo-22.jpg,2,2312,2726,1257,1289,SAUCE FteZA WITH SPICES,3264,2448,414,32
photo-22.jpg,1,220,301,1381,1407,13.38,3264,2448,81,26
photo-22.jpg,1,219,301,1344,1368,62.76,3264,2448,82,24
photo-22.jpg,1,218,299,1304,1330,31.38,3264,2448,81,26
photo-22.jpg,1,560,644,1376,1402,13.38,3264,2448,84,26
photo-22.jpg,3,560,643,1338,1371,62.'76,3264,2448,83,33
photo-22.jpg,1,559,641,1299,1324,31.38,3264,2448,82,25
photo-22.jpg,1,731,813,1375,1400,13.38,3264,2448,82,25
photo-22.jpg,1,882,964,1372,1398,13.38,3264,2448,82,26
photo-22.jpg,3,1387,1486,1365,1389,1.9KG,3264,2448,99,24
photo-22.jpg,3,1385,1486,1326,1350,2.7 KG,3264,2448,101,24
photo-22.jpg,3,1386,1485,1279,1311,4.2 JCG,3264,2448,99,32
photo-22.jpg,1,1052,1067,1371,1394,1,3264,2448,15,23
photo-22.jpg,3,1655,1809,1359,1382,SANDHURST,3264,2448,154,23
photo-22.jpg,3,1655,1809,1320,1343,SANDHURST,3264,2448,154,23
photo-22.jpg,3,1726,1809,1281,1303,MUTTI,3264,2448,83,22
photo-22.jpg,1,2804,2875,1335,1361,2745,3264,2448,71,26
photo-22.jpg,3,1285,1334,1367,1388,JAR,3264,2448,49,21
photo-22.jpg,3,2765,2874,1293,1321,1293S7,3264,2448,109,28
photo-22.jpg,1,2785,2872,1254,1280,39733,3264,2448,87,26
photo-22.jpg,1,730,795,1335,1362,5.23,3264,2448,65,27
photo-22.jpg,1,882,947,1334,1360,5.23,3264,2448,65,26
photo-22.jpg,1,1052,1084,1333,1357,12,3264,2448,32,24
photo-22.jpg,3,1285,1335,1327,1349,CAN,3264,2448,50,22
photo-22.jpg,1,729,811,1298,1323,10.46,3264,2448,82,25
photo-22.jpg,3,881,1065,1283,1321,3_10.46,3264,2448,184,38
photo-22.jpg,3,1285,1334,1288,1310,CAN,3264,2448,49,22
photo-23.jpg,2,2487,2762,1381,1405,CREAM THICKENED,3264,2448,275,24
photo-23.jpg,2,2683,2756,1261,1283,MILO,3264,2448,73,22
photo-23.jpg,1,594,679,1422,1446,31.10,3264,2448,85,24
photo-23.jpg,1,767,849,1416,1442,15.55,3264,2448,82,26
photo-23.jpg,1,918,999,1413,1439,15.55,3264,2448,81,26
photo-23.jpg,1,1087,1101,1412,1435,2,3264,2448,14,23
photo-23.jpg,3,1454,1522,1405,1427,4 LT,3264,2448,68,22
photo-23.jpg,1,2797,2909,1379,1404,144592,3264,2448,112,25
photo-23.jpg,3,1321,1369,1407,1428,BTL,3264,2448,48,21
photo-23.jpg,3,1638,1844,1398,1421,CATERERS CHO,3264,2448,206,23
photo-23.jpg,3,3248,3264,1291,1319,p,3264,2448,16,28
photo-23.jpg,1,252,352,1312,1339,103.52,3264,2448,100,27
photo-23.jpg,1,595,696,1304,1330,103.52,3264,2448,101,26
photo-23.jpg,1,765,847,1301,1325,25.88,3264,2448,82,24
photo-23.jpg,1,916,998,1298,1323,25.88,3264,2448,82,25
photo-23.jpg,3,1420,1520,1287,1311,1.9 KG,3264,2448,100,24
photo-23.jpg,1,2832,2903,1258,1282,1455,3264,2448,71,24
photo-23.jpg,1,1084,1101,1297,1317,4,3264,2448,17,20
photo-23.jpg,3,1319,1369,1290,1311,CAN,3264,2448,50,21
photo-23.jpg,3,1740,1842,1281,1303,NESTLE,3264,2448,102,22
photo-24.jpg,2,2295,2721,1412,1445,BURGER PATTIES VEGETABLE,3264,2448,426,33
photo-24.jpg,2,2291,2717,1292,1329,CORDIAL ORANGE 25% JUICE,3264,2448,426,37
photo-24.jpg,2,2236,2715,1252,1293,CORDIAL RASPBERRY 25% JUICE,3264,2448,479,41
photo-24.jpg,2,2235,2713,1214,1256,DOYLEYS OVAL NO 2 170X270MM,3264,2448,478,42
photo-24.jpg,2,2303,2711,1169,1214,DOYLEYS ROUND 10 250MM,3264,2448,408,45
photo-24.jpg,2,2181,2708,1135,1180,PAPER EASY-BAKE 30CM DISPENSER,3264,2448,527,45
photo-24.jpg,1,778,856,1463,1488,35.75,3264,2448,78,25
photo-24.jpg,3,1307,1502,1448,1474,60 X 100 CTN,3264,2448,195,26
photo-24.jpg,1,922,1000,1459,1484,35.75,3264,2448,78,25
photo-24.jpg,1,1083,1098,1458,1480,1,3264,2448,15,22
photo-24.jpg,3,1617,1818,1439,1465,COLONIAL FAR,3264,2448,201,26
photo-24.jpg,3,2779,2867,1408,1435,3X405,3264,2448,88,27
photo-24.jpg,1,295,371,1360,1386,18.35,3264,2448,76,26
photo-24.jpg,1,617,696,1355,1379,16.68,3264,2448,79,24
photo-24.jpg,3,1435,1501,1335,1360,2 LT,3264,2448,66,25
photo-24.jpg,3,1433,1500,1298,1322,2 LT,3264,2448,67,24
photo-24.jpg,3,1419,1499,1259,1285,250'S,3264,2448,80,26
photo-24.jpg,3,1417,1499,1220,1248,250'S,3264,2448,82,28
photo-24.jpg,3,1381,1387,1232,1235,•,3264,2448,6,3
photo-24.jpg,3,1368,1497,1185,1211,30CM X 1,3264,2448,129,26
photo-24.jpg,1,778,840,1351,1376,2.78,3264,2448,62,25
photo-24.jpg,1,470,533,1358,1382,1.67,3264,2448,63,24
photo-24.jpg,1,1081,1097,1346,1368,6,3264,2448,16,22
photo-24.jpg,1,921,985,1347,1372,2.78,3264,2448,64,25
photo-24.jpg,3,1683,1815,1325,1350,SUNSHINE,3264,2448,132,25
photo-24.jpg,3,1681,1814,1287,1312,SUNSHINE,3264,2448,133,25
photo-24.jpg,3,1679,1814,1249,1274,CASTAWAY,3264,2448,135,25
photo-24.jpg,3,1679,1812,1210,1236,CASTAWAY,3264,2448,133,26
photo-24.jpg,3,1678,1811,1174,1198,CASTAWAY,3264,2448,133,24
photo-24.jpg,3,1307,1353,1339,1360,BTL,3264,2448,46,21
photo-24.jpg,1,2773,2862,1287,1314,14916,3264,2448,89,27
photo-24.jpg,1,2771,2861,1247,1276,15104,3264,2448,90,29
photo-24.jpg,1,2787,2858,1208,1234,3013,3264,2448,71,26
photo-24.jpg,1,2786,2857,1167,1195,1682,3264,2448,71,28
photo-24.jpg,1,2766,2854,1126,1156,30815,3264,2448,88,30
photo-24.jpg,1,294,370,1323,1348,18.35,3264,2448,76,25
photo-24.jpg,1,616,695,1318,1341,16.68,3264,2448,79,23
photo-24.jpg,1,777,840,1315,1338,2.78,3264,2448,63,23
photo-24.jpg,1,469,533,1321,1345,1.67,3264,2448,64,24
photo-24.jpg,1,921,984,1310,1335,2.78,3264,2448,63,25
photo-24.jpg,1,1081,1097,1309,1331,6,3264,2448,16,22
photo-24.jpg,3,1306,1353,1303,1322,BTL,3264,2448,47,19
photo-24.jpg,1,293,354,1286,1312,6.28,3264,2448,61,26
photo-24.jpg,1,615,678,1281,1305,5.71,3264,2448,63,24
photo-24.jpg,1,469,533,1284,1307,0.57,3264,2448,64,23
photo-24.jpg,1,920,982,1273,1298,5.71,3264,2448,62,25
photo-24.jpg,1,776,838,1277,1301,5.71,3264,2448,62,24
photo-24.jpg,1,1080,1096,1271,1293,1,3264,2448,16,22
photo-24.jpg,3,1304,1352,1265,1284,BND,3264,2448,48,19
photo-24.jpg,1,292,354,1248,1274,5.37,3264,2448,62,26
photo-24.jpg,1,615,679,1244,1268,4.88,3264,2448,64,24
photo-24.jpg,1,469,533,1246,1270,0.49,3264,2448,64,24
photo-24.jpg,1,777,839,1240,1265,4.88,3264,2448,62,25
photo-24.jpg,1,1081,1096,1234,1256,1,3264,2448,15,22
photo-24.jpg,1,921,982,1236,1260,4.88,3264,2448,61,24
photo-24.jpg,3,1304,1351,1220,1247,BN?,3264,2448,47,27
photo-24.jpg,1,293,369,1212,1238,52.73,3264,2448,76,26
photo-24.jpg,1,616,695,1208,1230,47.94,3264,2448,79,22
photo-24.jpg,1,469,533,1210,1233,4.79,3264,2448,64,23
photo-24.jpg,1,777,854,1204,1227,23.97,3264,2448,77,23
photo-24.jpg,1,1082,1095,1197,1220,2,3264,2448,13,23
photo-24.jpg,1,921,998,1199,1224,23.97,3264,2448,77,25
photo-24.jpg,3,1289,1350,1189,1210,ROLL,3264,2448,61,21
photo-25.jpg,2,2195,2755,1273,1317,BURGERS BEEF GOURMET PAR COOKED,3264,2448,560,44
photo-25.jpg,2,2388,2754,1233,1272,HOTCAKES PLAIN 100MM,3264,2448,366,39
photo-25.jpg,2,2385,2751,1194,1230,PAVLOVA SLAB VANILLA,3264,2448,366,36
photo-25.jpg,2,2549,2749,1152,1183,POTATO GEMS,3264,2448,200,31
photo-25.jpg,2,2101,2748,1113,1164,SCHNITZEL CHICKEN BREAST GLUTEN FREE,3264,2448,647,51
photo-25.jpg,2,2310,2747,1072,1116,SCHNITZEL CHICKEN MEDIUM,3264,2448,437,44
photo-25.jpg,1,2796,2906,1267,1294,137474,3264,2448,110,27
photo-25.jpg,1,2794,2904,1225,1254,151717,3264,2448,110,29
photo-25.jpg,1,2811,2902,1186,1214,28173,3264,2448,91,28
photo-25.jpg,3,252,332,1321,1355,77! 48,3264,2448,80,34
photo-25.jpg,1,251,331,1283,1309,71.17,3264,2448,80,26
photo-25.jpg,1,249,330,1245,1271,72.00,3264,2448,81,26
photo-25.jpg,3,244,330,1200,1234,30:12.,3264,2448,86,34
photo-25.jpg,1,249,348,1168,1195,231.20,3264,2448,99,27
photo-25.jpg,1,587,668,1312,1337,70.44,3264,2448,81,25
photo-25.jpg,1,586,668,1274,1299,64.70,3264,2448,82,25
photo-25.jpg,1,584,666,1235,1261,72.00,3264,2448,82,26
photo-25.jpg,1,585,665,1197,1223,30.42,3264,2448,80,26
photo-25.jpg,1,583,684,1159,1185,231.20,3264,2448,101,26
photo-25.jpg,1,754,835,1305,1331,23.48,3264,2448,81,26
photo-25.jpg,1,754,835,1268,1293,12.94,3264,2448,81,25
photo-25.jpg,1,905,986,1299,1326,23.48,3264,2448,81,27
photo-25.jpg,1,903,985,1262,1288,12.94,3264,2448,82,26
photo-25.jpg,3,1373,1508,1321,1350,60 X 120,3264,2448,135,29
photo-25.jpg,3,1390,1507,1282,1311,8 X 6'S,3264,2448,117,29
photo-25.jpg,3,1388,1506,1245,1271,1.15 KG,3264,2448,118,26
photo-25.jpg,3,1437,1504,1207,1232,2 KG,3264,2448,67,25
photo-25.jpg,3,1369,1502,1169,1196,10 X 100,3264,2448,133,27
photo-25.jpg,3,1368,1500,1131,1158,30 X 160,3264,2448,132,27
photo-25.jpg,3,1307,1356,1327,1349,CTN,3264,2448,49,22
photo-25.jpg,3,1626,1832,1311,1338,CATERERS CHO,3264,2448,206,27
photo-25.jpg,3,1712,1830,1271,1297,MARCELS,3264,2448,118,26
photo-25.jpg,3,1625,1829,1233,1261,COUNTRY CHEF,3264,2448,204,28
photo-25.jpg,3,1726,1825,1195,1218,EDGELL,3264,2448,99,23
photo-25.jpg,3,1724,1825,1155,1180,INGHAM,3264,2448,101,25
photo-25.jpg,3,1723,1824,1117,1142,INGHAM,3264,2448,101,25
photo-25.jpg,1,435,500,1317,1341,7.04,3264,2448,65,24
photo-25.jpg,1,435,499,1278,1303,6.47,3264,2448,64,25
photo-25.jpg,1,1073,1086,1298,1321,3,3264,2448,13,23
photo-25.jpg,3,1306,1356,1289,1311,CTN,3264,2448,50,22
photo-25.jpg,1,1071,1085,1259,1282,5,3264,2448,14,23
photo-25.jpg,3,1287,1356,1251,1273,TRAY,3264,2448,69,22
photo-25.jpg,1,751,817,1229,1256,6.00,3264,2448,66,27
photo-25.jpg,1,901,967,1222,1250,6.00,3264,2448,66,28
photo-25.jpg,1,1070,1101,1220,1245,12,3264,2448,31,25
photo-25.jpg,3,1302,1351,1212,1234,PICT,3264,2448,49,22
photo-25.jpg,1,2846,2898,1144,1172,322,3264,2448,52,28
photo-25.jpg,1,2788,2898,1105,1134,140673,3264,2448,110,29
photo-25.jpg,1,2787,2896,1064,1093,135012,3264,2448,109,29
photo-25.jpg,1,750,833,1191,1217,15.21,3264,2448,83,26
photo-25.jpg,1,751,834,1153,1179,46.24,3264,2448,83,26
photo-25.jpg,1,900,983,1186,1212,15.21,3264,2448,83,26
photo-25.jpg,3,900,983,1147,1183,46^24,3264,2448,83,36
photo-25.jpg,1,1069,1084,1183,1206,2,3264,2448,15,23
photo-25.jpg,3,1300,1350,1174,1197,PKT,3264,2448,50,23
photo-25.jpg,1,1068,1081,1145,1168,5,3264,2448,13,23
photo-25.jpg,3,1302,1350,1136,1158,CTN,3264,2448,48,22
photo-26.jpg,2,2505,2768,1380,1404,DRESSING GREEK,3264,2448,263,24
photo-26.jpg,2,2140,2766,1338,1369,SAUCE MEAL SUNDRIED TOMATO & BASIL,3264,2448,626,31
photo-26.jpg,2,2540,2766,1255,1280,SAUCE TOMATO,3264,2448,226,25
photo-26.jpg,2,2539,2767,1297,1322,SAUCE TOMATO,3264,2448,228,25
photo-26.jpg,2,2427,2764,1214,1242,SEASONING MOROCCAN,3264,2448,337,28
photo-26.jpg,1,200,283,1411,1437,17.32,3264,2448,83,26
photo-26.jpg,1,198,282,1373,1398,32.30,3264,2448,84,25
photo-26.jpg,1,199,282,1333,1358,17.18,3264,2448,83,25
photo-26.jpg,1,198,282,1293,1319,25.77,3264,2448,84,26
photo-26.jpg,1,196,280,1254,1280,14.66,3264,2448,84,26
photo-26.jpg,1,548,631,1406,1432,17.32,3264,2448,83,26
photo-26.jpg,1,546,630,1367,1392,32.30,3264,2448,84,25
photo-26.jpg,1,545,630,1327,1353,17.18,3264,2448,85,26
photo-26.jpg,1,545,630,1288,1313,25.77,3264,2448,85,25
photo-26.jpg,1,545,629,1250,1275,14.66,3264,2448,84,25
photo-26.jpg,1,721,804,1405,1429,17.32,3264,2448,83,24
photo-26.jpg,1,720,803,1365,1389,16.15,3264,2448,83,24
photo-26.jpg,1,2808,2921,1378,1404,144529,3264,2448,113,26
photo-26.jpg,1,2827,2919,1335,1362,94493,3264,2448,92,27
photo-26.jpg,1,2805,2918,1294,1321,160034,3264,2448,113,27
photo-26.jpg,1,2805,2918,1252,1278,160034,3264,2448,113,26
photo-26.jpg,1,2824,2917,1212,1237,11489,3264,2448,93,25
photo-26.jpg,1,876,958,1402,1427,17.32,3264,2448,82,25
photo-26.jpg,1,874,958,1362,1388,16.15,3264,2448,84,26
photo-26.jpg,3,1422,1489,1395,1420,3 LT,3264,2448,67,25
photo-26.jpg,3,1388,1488,1356,1379,2.1 KG,3264,2448,100,23
photo-26.jpg,3,1420,1490,1316,1341,4 LT,3264,2448,70,25
photo-26.jpg,3,1419,1489,1275,1300,4 LT,3264,2448,70,25
photo-26.jpg,3,1386,1488,1237,1260,755 GR,3264,2448,102,23
photo-26.jpg,1,1045,1061,1401,1423,1,3264,2448,16,22
photo-26.jpg,3,1630,1822,1391,1415,MASTERFOODS,3264,2448,192,24
photo-26.jpg,3,1630,1821,1351,1374,MASTER; FOODS,3264,2448,191,23
photo-26.jpg,3,1630,1820,1311,1335,MASTERFOODS,3264,2448,190,24
photo-26.jpg,3,1629,1820,1271,1295,MASTERFOODS,3264,2448,191,24
photo-26.jpg,3,1629,1819,1232,1256,MASTERFOODS,3264,2448,190,24
photo-26.jpg,3,1286,1334,1398,1418,BTL,3264,2448,48,20
photo-26.jpg,1,1045,1060,1362,1385,2,3264,2448,15,23
photo-26.jpg,3,1283,1333,1358,1378,JAR,3264,2448,50,20
photo-26.jpg,1,1045,1059,1322,1346,2,3264,2448,14,24
photo-26.jpg,1,874,940,1324,1349,8.59,3264,2448,66,25
photo-26.jpg,1,719,785,1325,1350,8.59,3264,2448,66,25
photo-26.jpg,3,1284,1332,1319,1339,BTL,3264,2448,48,20
photo-26.jpg,1,1046,1059,1282,1306,3,3264,2448,13,24
photo-26.jpg,1,719,785,1287,1310,8.59,3264,2448,66,23
photo-26.jpg,3,874,940,1284,1308,8.S9,3264,2448,66,24
photo-26.jpg,3,1284,1333,1279,1299,BTL,3264,2448,49,20
photo-26.jpg,1,717,801,1248,1272,14.66,3264,2448,84,24
photo-26.jpg,1,1042,1059,1244,1267,1,3264,2448,17,23
photo-26.jpg,1,873,956,1244,1269,14.66,3264,2448,83,25
photo-26.jpg,3,1253,1334,1232,1262,CAN .,3264,2448,81,30
photo-26.jpg,3,1204,1210,1233,1237,.,3264,2448,6,4
photo-27.jpg,2,1230,1258,1277,1689,Bananas - Cavendish Carton,3264,2448,28,412
photo-27.jpg,2,1277,1304,1418,1690,Passionfmit - Each,3264,2448,27,272
photo-27.jpg,2,1353,1387,1310,1688,Tomatoes - Cherry Punnet,3264,2448,34,378
photo-27.jpg,2,1401,1429,1248,1691,Mushrooms - Small Button Ctn,3264,2448,28,443
photo-27.jpg,2,1449,1483,1262,1690,Cucumbers - Continental Bag,3264,2448,34,428
photo-27.jpg,2,1497,1530,1198,1690,Capsicums - Red Economy Loose,3264,2448,33,492
photo-27.jpg,1,1228,1253,2009,2024,1,3264,2448,25,15
photo-27.jpg,3,1228,1256,1805,1906,FB 101,3264,2448,28,101
photo-27.jpg,3,1274,1302,1802,1906,FP 119,3264,2448,28,104
photo-27.jpg,1,1231,1259,886,987,$22.00,3264,2448,28,101
photo-27.jpg,1,1277,1306,895,978,$0.65,3264,2448,29,83
photo-27.jpg,3,1227,1250,307,362,FRE,3264,2448,23,55
photo-27.jpg,1,1231,1259,523,622,$22.00,3264,2448,28,99
photo-27.jpg,1,1275,1301,2006,2047,20,3264,2448,26,41
photo-27.jpg,1,1278,1302,742,776,10,3264,2448,24,34
photo-27.jpg,3,1275,1297,305,360,FRE,3264,2448,22,55
photo-27.jpg,3,1312,1336,733,777,0%,3264,2448,24,44
photo-27.jpg,1,1352,1378,2010,2047,15,3264,2448,26,37
photo-27.jpg,3,1352,1379,1803,1909,VT 105,3264,2448,27,106
photo-27.jpg,3,1399,1427,1799,1913,VM 115,3264,2448,28,114
photo-27.jpg,3,1447,1475,1803,1912,VC 118,3264,2448,28,109
photo-27.jpg,3,1495,1523,1802,1915,VC 149,3264,2448,28,113
photo-27.jpg,1,1355,1384,894,976,$2.00,3264,2448,29,82
photo-27.jpg,1,1403,1431,883,983,$26.00,3264,2448,28,100
photo-27.jpg,1,1451,1479,882,983,$24.00,3264,2448,28,101
photo-27.jpg,1,1498,1527,889,972,$3.95,3264,2448,29,83
photo-27.jpg,1,1356,1384,519,619,$30.00,3264,2448,28,100
photo-27.jpg,1,1404,1431,518,617,$26.00,3264,2448,27,99
photo-27.jpg,1,1450,1479,518,616,$24.00,3264,2448,29,98
photo-27.jpg,1,1498,1527,525,606,$9.84,3264,2448,29,81
photo-27.jpg,3,1354,1376,304,358,FRE,3264,2448,22,54
photo-27.jpg,1,1401,1427,2013,2029,1,3264,2448,26,16
photo-27.jpg,3,1400,1423,303,357,FRF.,3264,2448,23,54
photo-27.jpg,1,1448,1474,2015,2031,1,3264,2448,26,16
photo-27.jpg,3,1447,1472,301,356,FRE,3264,2448,25,55
photo-27.jpg,1,1497,1523,2013,2099,2.492,3264,2448,26,86
photo-27.jpg,3,1496,1519,300,353,FRE,3264,2448,23,53
photo-28.jpg,2,1205,1235,1290,1649,Pinkladys - Special Carton,3264,2448,30,359
photo-28.jpg,2,1251,1280,1301,1650,Mandarins - Large Carton,3264,2448,29,349
photo-28.jpg,2,1295,1325,1388,1648,Oranges - Bulk kgs,3264,2448,30,260
photo-28.jpg,2,1341,1372,1257,1650,Potatoes - White Chats 20kg,3264,2448,31,393
photo-28.jpg,2,1386,1417,1308,1650,Onions - Large Bag 20kg,3264,2448,31,342
photo-28.jpg,1,1209,1234,883,978,$34.00,3264,2448,25,95
photo-28.jpg,1,1253,1278,883,978,$28.00,3264,2448,25,95
photo-28.jpg,1,1299,1323,891,969,$1.65,3264,2448,24,78
photo-28.jpg,1,1345,1370,882,979,$26.00,3264,2448,25,97
photo-28.jpg,1,1390,1415,882,978,$29.50,3264,2448,25,96
photo-28.jpg,1,1202,1225,1952,1964,1,3264,2448,23,12
photo-28.jpg,3,1204,1228,1756,1851,FA 130,3264,2448,24,95
photo-28.jpg,3,1247,1272,1756,1858,FM 101,3264,2448,25,102
photo-28.jpg,3,1292,1317,1754,1857,FO 105,3264,2448,25,103
photo-28.jpg,3,1339,1363,1756,1855,PP 106,3264,2448,24,99
photo-28.jpg,3,1383,1409,1754,1859,PO 103,3264,2448,26,105
photo-28.jpg,1,1212,1235,530,624,$34.00,3264,2448,23,94
photo-28.jpg,1,1256,1281,530,624,$28.00,3264,2448,25,94
photo-28.jpg,1,1302,1325,527,623,$24.75,3264,2448,23,96
photo-28.jpg,1,1347,1372,528,623,$28.00,3264,2448,25,95
photo-28.jpg,1,1393,1416,529,620,$29.50,3264,2448,23,91
photo-28.jpg,1,1247,1270,1952,1965,1,3264,2448,23,13
photo-28.jpg,1,1292,1315,1950,1984,15,3264,2448,23,34
photo-28.jpg,1,1339,1361,1954,1967,1,3264,2448,22,13
photo-28.jpg,1,1384,1407,1955,1968,1,3264,2448,23,13
photo-29.jpg,2,1229,1261,1369,1719,Pinkladys - Special Carton,3264,2448,32,350
photo-29.jpg,2,1272,1299,1335,1720,Bananas - Cavendish Carton,3264,2448,27,385
photo-29.jpg,2,1316,1345,1379,1719,Mandarins - Large Carton,3264,2448,29,340
photo-29.jpg,2,1359,1392,1398,1718,Pineapples Xlarge Bach,3264,2448,33,320
photo-29.jpg,2,1404,1434,1468,1719,Rockmelons - Tray,3264,2448,30,251
photo-29.jpg,2,1448,1478,1330,1719,Strawberries - 250gm punnet,3264,2448,30,389
photo-29.jpg,2,1493,1521,1406,1716,Watermelon - Seedless,3264,2448,28,310
photo-29.jpg,2,1538,1569,1366,1717,Tomatoes - Cherry Punnet,3264,2448,31,351
photo-29.jpg,2,1582,1610,1322,1718,Cucumbers - Continental Bag,3264,2448,28,396
photo-29.jpg,2,1627,1661,1368,1717,Capsicums - Green Loose,3264,2448,34,349
photo-29.jpg,2,1671,1705,1260,1717,Capsicums - Red Economy Loose,3264,2448,34,457
photo-29.jpg,2,1715,1746,1331,1720,Mesculin 3kg Qld Mix Carton,3264,2448,31,389
photo-29.jpg,3,1207,1235,430,480,tt*,3264,2448,28,50
photo-29.jpg,1,1232,1256,2012,2027,1,3264,2448,24,15
photo-29.jpg,3,1231,1257,1820,1916,FA 130,3264,2448,26,96
photo-29.jpg,3,1275,1300,1823,1918,FB 101,3264,2448,25,95
photo-29.jpg,3,1319,1345,1821,1920,FM 101,3264,2448,26,99
photo-29.jpg,3,1364,1389,1819,1917,FP 109,3264,2448,25,98
photo-29.jpg,3,1408,1433,1818,1919,FR 105,3264,2448,25,101
photo-29.jpg,3,1451,1478,1824,1919,FS 101,3264,2448,27,95
photo-29.jpg,3,1496,1523,1816,1922,FW102,3264,2448,27,106
photo-29.jpg,3,1541,1567,1820,1921,VT105,3264,2448,26,101
photo-29.jpg,3,1586,1613,1820,1922,VC 118,3264,2448,27,102
photo-29.jpg,3,1631,1657,1819,1922,VC 138,3264,2448,26,103
photo-29.jpg,3,1677,1701,1818,1923,VC 149,3264,2448,24,105
photo-29.jpg,3,1721,1747,1814,1927,MM 109,3264,2448,26,113
photo-29.jpg,1,1221,1250,971,1066,$3200,3264,2448,29,95
photo-29.jpg,1,1265,1293,970,1063,$1000,3264,2448,28,93
photo-29.jpg,3,1308,1338,971,1065,§26. 00,3264,2448,30,94
photo-29.jpg,1,1353,1381,976,1054,$260,3264,2448,28,78
photo-29.jpg,3,1397,1424,967,1060,"$36,00",3264,2448,27,93
photo-29.jpg,3,1441,1469,975,1052,$3 06,3264,2448,28,77
photo-29.jpg,1,1486,1514,975,1050,$126,3264,2448,28,75
photo-29.jpg,3,1530,1561,972,1051,$2/40,3264,2448,31,79
photo-29.jpg,1,1576,1603,963,1057,$2200,3264,2448,27,94
photo-29.jpg,3,1620,1648,971,1048,"$3,96",3264,2448,28,77
photo-29.jpg,3,1664,1693,970,1047,"$3,96",3264,2448,29,77
photo-29.jpg,1,1709,1737,959,1055,$3200,3264,2448,28,96
photo-29.jpg,3,1217,1243,629,722,$32 00,3264,2448,26,93
photo-29.jpg,3,1258,1289,627,720,"$16,00",3264,2448,31,93
photo-29.jpg,3,1302,1334,626,718,"$26,00",3264,2448,32,92
photo-29.jpg,1,1347,1377,624,717,$30.00,3264,2448,30,93
photo-29.jpg,3,1392,1420,624,716,$96 (X),3264,2448,28,92
photo-29.jpg,1,1436,1463,623,715,$7110,3264,2448,27,92
photo-29.jpg,3,1479,1510,621,713,"$31,13",3264,2448,31,92
photo-29.jpg,3,1524,1555,618,712,"$26,00",3264,2448,31,94
photo-29.jpg,3,1571,1598,619,710,$22 00,3264,2448,27,91
photo-29.jpg,3,1614,1645,624,701,"$7,00",3264,2448,31,77
photo-29.jpg,3,1657,1689,623,702,"$7,00",3264,2448,32,79
photo-29.jpg,3,1703,1732,614,707,"$92,00",3264,2448,29,93
photo-29.jpg,3,1254,1277,432,478,rt*,3264,2448,23,46
photo-29.jpg,1,1276,1300,2012,2028,1,3264,2448,24,16
photo-29.jpg,3,1292,1326,428,477,ft*,3264,2448,34,49
photo-29.jpg,1,1320,1344,2012,2028,1,3264,2448,24,16
photo-29.jpg,3,1338,1368,429,476,ft*,3264,2448,30,47
photo-29.jpg,1,1365,1390,2010,2045,12,3264,2448,25,35
photo-29.jpg,3,1384,1411,430,474,ft*,3264,2448,27,44
photo-29.jpg,1,1410,1433,2013,2029,1,3264,2448,23,16
photo-29.jpg,3,1429,1457,425,472,ft*,3264,2448,28,47
photo-29.jpg,1,1454,1478,2011,2046,18,3264,2448,24,35
photo-29.jpg,3,1472,1500,423,471,ft*,3264,2448,28,48
photo-29.jpg,1,1499,1523,2012,2075,24.9,3264,2448,24,63
photo-29.jpg,3,1518,1545,423,469,ft*,3264,2448,27,46
photo-29.jpg,1,1544,1569,2012,2046,15,3264,2448,25,34
photo-29.jpg,3,1562,1590,420,468,ft*,3264,2448,28,48
photo-29.jpg,1,1589,1613,2015,2030,1,3264,2448,24,15
photo-29.jpg,3,1606,1635,419,466,ft*,3264,2448,29,47
photo-29.jpg,1,1633,1657,2012,2032,2,3264,2448,24,20
photo-29.jpg,3,1648,1679,414,466,ft*,3264,2448,31,52
photo-29.jpg,1,1678,1702,2012,2031,2,3264,2448,24,19
photo-29.jpg,3,1693,1724,413,464,ft*,3264,2448,31,51
photo-29.jpg,1,1725,1748,2015,2031,1,3264,2448,23,16
photo-30.jpg,2,1198,1228,1441,1671,Kiwifruit loose kg,3264,2448,30,230
photo-30.jpg,2,1242,1268,1413,1669,Passionfruit - Each,3264,2448,26,256
photo-30.jpg,2,1283,1313,1229,1669,Tomatoes - Mediums Choice Ctn,3264,2448,30,440
photo-30.jpg,2,1328,1358,1255,1670,Mushrooms - Small Button Ctn,3264,2448,30,415
photo-30.jpg,2,1374,1406,1363,1670,Carrots - Large Carton,3264,2448,32,307
photo-30.jpg,2,1418,1451,1329,1669,Onions - Large Bag 20kg,3264,2448,33,340
photo-30.jpg,2,1465,1495,1425,1668,Onions - Red Bag,3264,2448,30,243
photo-30.jpg,2,1508,1538,1279,1671,Potatoes - White Chats 20kg,3264,2448,30,392
photo-30.jpg,2,1554,1586,1250,1672,Potatoes - Sweet Large Carton,3264,2448,32,422
photo-30.jpg,2,1599,1635,1244,1670,Spinach 1.5kg Premium Carton,3264,2448,36,426
photo-30.jpg,2,1646,1679,1277,1671,Mesculin 3kg Qld Mix Carton,3264,2448,33,394
photo-30.jpg,1,1203,1228,1965,2024,1.90,3264,2448,25,59
photo-30.jpg,3,1201,1228,1778,1873,FK101,3264,2448,27,95
photo-30.jpg,3,1245,1272,1773,1871,FP 119,3264,2448,27,98
photo-30.jpg,3,1289,1316,1777,1874,VT101,3264,2448,27,97
photo-30.jpg,3,1334,1362,1771,1877,VM 115,3264,2448,28,106
photo-30.jpg,3,1378,1406,1772,1875,VC 113,3264,2448,28,103
photo-30.jpg,3,1423,1451,1771,1876,PO 103,3264,2448,28,105
photo-30.jpg,3,1468,1496,1771,1875,PO 105,3264,2448,28,104
photo-30.jpg,3,1514,1541,1772,1873,PP106,3264,2448,27,101
photo-30.jpg,3,1560,1588,1779,1872,PP 111,3264,2448,28,93
photo-30.jpg,3,1605,1632,1771,1877,MS 102,3264,2448,27,106
photo-30.jpg,3,1651,1678,1767,1881,MM 109,3264,2448,27,114
photo-30.jpg,3,1183,1204,359,412,FRE,3264,2448,21,53
photo-30.jpg,1,1191,1218,922,1000,$3.95,3264,2448,27,78
photo-30.jpg,1,1235,1263,920,1000,$0.65,3264,2448,28,80
photo-30.jpg,1,1280,1306,912,1007,$36.00,3264,2448,26,95
photo-30.jpg,1,1324,1350,910,1006,$26.00,3264,2448,26,96
photo-30.jpg,1,1368,1396,909,1005,$33.00,3264,2448,28,96
photo-30.jpg,1,1413,1440,908,1004,$29.50,3264,2448,27,96
photo-30.jpg,1,1458,1486,907,1002,$20.00,3264,2448,28,95
photo-30.jpg,1,1504,1532,906,1003,$28.00,3264,2448,28,97
photo-30.jpg,1,1551,1579,907,1002,$26.00,3264,2448,28,95
photo-30.jpg,1,1596,1623,906,1001,$16.00,3264,2448,27,95
photo-30.jpg,1,1641,1669,904,1001,$32.00,3264,2448,28,97
photo-30.jpg,1,1188,1214,574,651,$7.86,3264,2448,26,77
photo-30.jpg,1,1232,1259,563,658,$13.00,3264,2448,27,95
photo-30.jpg,1,1276,1302,563,656,$38.00,3264,2448,26,93
photo-30.jpg,1,1321,1347,561,655,$26.00,3264,2448,26,94
photo-30.jpg,1,1365,1392,559,654,$33.00,3264,2448,27,95
photo-30.jpg,1,1410,1436,559,653,$29.50,3264,2448,26,94
photo-30.jpg,1,1455,1482,557,651,$20.00,3264,2448,27,94
photo-30.jpg,1,1500,1528,554,651,$28.00,3264,2448,28,97
photo-30.jpg,1,1547,1574,555,650,$26.00,3264,2448,27,95
photo-30.jpg,1,1592,1619,553,649,$18.00,3264,2448,27,96
photo-30.jpg,1,1637,1665,552,647,$32.00,3264,2448,28,95
photo-30.jpg,1,1247,1272,1963,2001,20,3264,2448,25,38
photo-30.jpg,3,1228,1249,358,411,FRE,3264,2448,21,53
photo-30.jpg,1,1291,1316,1968,1983,1,3264,2448,25,15
photo-30.jpg,3,1272,1293,357,409,FRE,3264,2448,21,52
photo-30.jpg,1,1335,1361,1966,1982,1,3264,2448,26,16
photo-30.jpg,3,1316,1337,355,407,FRE,3264,2448,21,52
photo-30.jpg,1,1381,1406,1967,1983,1,3264,2448,25,16
photo-30.jpg,3,1361,1382,353,406,FRE,3264,2448,21,53
photo-30.jpg,1,1425,1451,1968,1983,1,3264,2448,26,15
photo-30.jpg,3,1406,1428,353,404,FRE,3264,2448,22,51
photo-30.jpg,1,1471,1496,1967,1982,1,3264,2448,25,15
photo-30.jpg,3,1451,1472,350,402,FRE,3264,2448,21,52
photo-30.jpg,1,1515,1542,1967,1984,1,3264,2448,27,17
photo-30.jpg,3,1496,1518,349,401,FRE,3264,2448,22,52
photo-30.jpg,1,1563,1588,1970,1985,1,3264,2448,25,15
photo-30.jpg,3,1544,1565,348,400,FRE,3264,2448,21,52
photo-30.jpg,1,1607,1634,1969,1983,1,3264,2448,27,14
photo-30.jpg,3,1589,1610,347,398,FRE,3264,2448,21,51
photo-30.jpg,1,1655,1680,1970,1985,1,3264,2448,25,15
photo-30.jpg,3,1634,1656,345,398,FRE,3264,2448,22,53
photo-30.jpg,3,1663,1684,52,62,r,3264,2448,21,10
photo-31.jpg,2,1178,1214,1343,1703,Pmkladys - Special Carton,3264,2448,36,360
photo-31.jpg,2,1221,1256,1306,1702,Bananas - Cavendish Carton,3264,2448,35,396
photo-31.jpg,2,1268,1302,1351,1702,Mandarins - Large Carton,3264,2448,34,351
photo-31.jpg,2,1316,1348,1443,1700,Rockmekms-Tray,3264,2448,32,257
photo-31.jpg,2,1357,1393,1336,1697,Tomatoes - Cherry Punnet,3264,2448,36,361
photo-31.jpg,2,1401,1438,1258,1695,Tomatoes - Roma Economy Ctn,3264,2448,37,437
photo-31.jpg,2,1448,1485,1290,1695,Cucumbers - Continental Bag,3264,2448,37,405
photo-31.jpg,2,1499,1530,1450,1694,Onions - Red Bag,3264,2448,31,244
photo-31.jpg,2,1541,1576,1298,1693,Mescufn 3kg QM ktix Carton,3264,2448,35,395
photo-31.jpg,2,1591,1627,1428,1692,Honeydew - Carton,3264,2448,36,264
photo-31.jpg,3,1140,1163,372,426,FHE,3264,2448,23,54
photo-31.jpg,3,1186,1209,371,424,FHE,3264,2448,23,53
photo-31.jpg,1,1151,1176,579,677,$30.00,3264,2448,25,98
photo-31.jpg,1,1195,1222,578,674,$22.00,3264,2448,27,96
photo-31.jpg,3,1241,1269,576,674,SS2.00,3264,2448,28,98
photo-31.jpg,1,1288,1315,575,673,$32.00,3264,2448,27,98
photo-31.jpg,1,1332,1362,573,670,$30.00,3264,2448,30,97
photo-31.jpg,1,1378,1405,571,669,$14.00,3264,2448,27,98
photo-31.jpg,1,1424,1452,570,666,$2400,3264,2448,28,96
photo-31.jpg,1,1471,1497,567,665,$2400,3264,2448,26,98
photo-31.jpg,1,1517,1544,566,662,$32.00,3264,2448,27,96
photo-31.jpg,1,1563,1590,563,661,$12.00,3264,2448,27,98
photo-31.jpg,1,1197,1222,2002,2018,1,3264,2448,25,16
photo-31.jpg,1,1162,1189,934,1031,$30.00,3264,2448,27,97
photo-31.jpg,1,1208,1234,932,1028,$22.08,3264,2448,26,96
photo-31.jpg,1,1253,1281,931,1029,$52.00,3264,2448,28,98
photo-31.jpg,1,1299,1327,931,1026,$3200,3264,2448,28,95
photo-31.jpg,1,1344,1371,936,1017,$200,3264,2448,27,81
photo-31.jpg,1,1389,1418,927,1024,$14.00,3264,2448,29,97
photo-31.jpg,1,1435,1463,924,1020,$24.00,3264,2448,28,96
photo-31.jpg,1,1482,1509,923,1020,$26.00,3264,2448,27,97
photo-31.jpg,1,1528,1556,920,1018,$3200,3264,2448,28,98
photo-31.jpg,1,1573,1601,919,1016,$1200,3264,2448,28,97
photo-31.jpg,3,1190,1218,1807,1904,FA 130,3264,2448,28,97
photo-31.jpg,3,1236,1263,1809,1905,FB 101,3264,2448,27,96
photo-31.jpg,3,1281,1309,1806,1907,FM101,3264,2448,28,101
photo-31.jpg,3,1327,1355,1802,1904,FR 105,3264,2448,28,102
photo-31.jpg,3,1373,1401,1801,1903,VT105,3264,2448,28,102
photo-31.jpg,3,1418,1445,1801,1902,VT114,3264,2448,27,101
photo-31.jpg,3,1463,1491,1800,1903,VC 118,3264,2448,28,103
photo-31.jpg,3,1509,1538,1795,1901,PO 105,3264,2448,29,106
photo-31.jpg,3,1555,1585,1791,1905,MM 109,3264,2448,30,114
photo-31.jpg,3,1601,1630,1795,1898,FH 102,3264,2448,29,103
photo-31.jpg,1,1242,1268,2002,2016,1,3264,2448,26,14
photo-31.jpg,3,1232,1254,371,422,FHE,3264,2448,22,51
photo-31.jpg,1,1288,1313,2002,2015,1,3264,2448,25,13
photo-31.jpg,3,1278,1301,368,420,fhe,3264,2448,23,52
photo-31.jpg,1,1333,1359,2000,2015,1,3264,2448,26,15
photo-31.jpg,3,1324,1344,366,419,res,3264,2448,20,53
photo-31.jpg,1,1380,1404,1997,2030,15,3264,2448,24,33
photo-31.jpg,3,1369,1391,364,416,fhe,3264,2448,22,52
photo-31.jpg,1,1424,1450,1997,2012,1,3264,2448,26,15
photo-31.jpg,3,1415,1438,362,414,FHE,3264,2448,23,52
photo-31.jpg,1,1470,1496,1997,2013,1,3264,2448,26,16
photo-31.jpg,3,1460,1484,358,413,FHE,3264,2448,24,55
photo-31.jpg,1,1518,1542,1997,2009,1,3264,2448,24,12
photo-31.jpg,3,1508,1531,357,410,FHE,3264,2448,23,53
photo-31.jpg,1,1563,1589,1996,2010,1,3264,2448,26,14
photo-31.jpg,3,1553,1577,355,407,FHE,3264,2448,24,52
photo-31.jpg,1,1608,1635,1994,2008,1,3264,2448,27,14
photo-32.jpg,2,1187,1219,1343,1703,PinMadys - Special Carton,3264,2448,32,360
photo-32.jpg,2,1231,1261,1352,1702,Mandarins - Large Carton,3264,2448,30,350
photo-32.jpg,2,1278,1306,1381,1702,Watermelon - Seedless,3264,2448,28,321
photo-32.jpg,2,1321,1353,1265,1700,Tomatoes - Medium Special Ctn,3264,2448,32,435
photo-32.jpg,2,1368,1400,1307,1701,Mescuin 3kg Old Mix Carton,3264,2448,32,394
photo-32.jpg,3,1166,1188,384,434,FRE,3264,2448,22,50
photo-32.jpg,1,1177,1205,936,1031,126.00,3264,2448,28,95
photo-32.jpg,1,1223,1250,934,1031,$55.00,3264,2448,27,97
photo-32.jpg,1,1268,1295,943,1022,$1.25,3264,2448,27,79
photo-32.jpg,1,1315,1341,934,1029,$26.00,3264,2448,26,95
photo-32.jpg,1,1360,1386,933,1028,$32.00,3264,2448,26,95
photo-32.jpg,1,1173,1200,588,681,$26.00,3264,2448,27,93
photo-32.jpg,1,1217,1245,586,680,$55.00,3264,2448,28,94
photo-32.jpg,1,1263,1290,594,671,$3.15,3264,2448,27,77
photo-32.jpg,1,1309,1336,584,678,$26.00,3264,2448,27,94
photo-32.jpg,1,1354,1381,584,677,$32.00,3264,2448,27,93
photo-32.jpg,1,1194,1218,2006,2019,1,3264,2448,24,13
photo-32.jpg,3,1191,1218,1810,1907,FA 130,3264,2448,27,97
photo-32.jpg,3,1237,1263,1808,1909,FM 101,3264,2448,26,101
photo-32.jpg,3,1283,1309,1803,1911,FW102,3264,2448,26,108
photo-32.jpg,3,1329,1355,1807,1908,VT102,3264,2448,26,101
photo-32.jpg,3,1374,1400,1800,1912,MM 109,3264,2448,26,112
photo-32.jpg,3,1211,1233,382,433,FRE,3264,2448,22,51
photo-32.jpg,1,1241,1263,2004,2019,1,3264,2448,22,15
photo-32.jpg,3,1257,1278,382,431,FRE,3264,2448,21,49
photo-32.jpg,1,1286,1311,2003,2065,2.52,3264,2448,25,62
photo-32.jpg,3,1303,1323,380,431,FRE,3264,2448,20,51
photo-32.jpg,1,1333,1356,2004,2018,1,3264,2448,23,14
photo-32.jpg,3,1347,1369,379,429,FRE,3264,2448,22,50
photo-32.jpg,1,1378,1401,2003,2018,1,3264,2448,23,15
photo-33.jpg,2,1202,1226,1401,1645,Rockmefons Each,3264,2448,24,244
photo-33.jpg,2,1247,1276,1256,1645,Strawberries - 250gm punnet,3264,2448,29,389
photo-33.jpg,2,1292,1320,1342,1644,Carrots - Large Carton,3264,2448,28,302
photo-33.jpg,2,1336,1360,1235,1645,Mushrooms - Small Button Ctn,3264,2448,24,410
photo-33.jpg,2,1380,1409,1290,1642,Tomatoes - Cherry Punnet,3264,2448,29,352
photo-33.jpg,2,1424,1453,1260,1646,Potatoes - White Chats 20kg,3264,2448,29,386
photo-33.jpg,2,1469,1500,1334,1646,Pumpkin -Jap Each kg,3264,2448,31,312
photo-33.jpg,2,1513,1543,1261,1647,MescuEn 3kg Qld Mix Carton,3264,2448,30,386
photo-33.jpg,1,1202,1225,1937,1955,6,3264,2448,23,18
photo-33.jpg,3,1202,1225,1749,1845,FR101,3264,2448,23,96
photo-33.jpg,3,1247,1270,1751,1846,FS101,3264,2448,23,95
photo-33.jpg,3,1292,1315,1746,1846,VC 113,3264,2448,23,100
photo-33.jpg,3,1336,1360,1744,1849,VM 115,3264,2448,24,105
photo-33.jpg,3,1381,1404,1747,1846,VT105,3264,2448,23,99
photo-33.jpg,3,1425,1448,1747,1846,PP106,3264,2448,23,99
photo-33.jpg,3,1470,1493,1748,1845,PP 114,3264,2448,23,97
photo-33.jpg,3,1514,1538,1742,1854,MM 109,3264,2448,24,112
photo-33.jpg,1,1200,1226,901,978,$4.95,3264,2448,26,77
photo-33.jpg,1,1244,1270,902,979,$4.00,3264,2448,26,77
photo-33.jpg,1,1290,1315,891,987,$38.00,3264,2448,25,96
photo-33.jpg,1,1334,1360,891,986,$26.00,3264,2448,26,95
photo-33.jpg,1,1379,1404,899,977,$2.00,3264,2448,25,78
photo-33.jpg,1,1423,1449,890,986,$46.00,3264,2448,26,96
photo-33.jpg,1,1469,1494,899,976,$1.40,3264,2448,25,77
photo-33.jpg,1,1514,1539,891,985,$32.00,3264,2448,25,94
photo-33.jpg,1,1201,1227,548,640,$29.70,3264,2448,26,92
photo-33.jpg,1,1246,1272,549,640,$60.00,3264,2448,26,91
photo-33.jpg,1,1291,1316,546,639,$38.00,3264,2448,25,93
photo-33.jpg,1,1335,1361,545,638,$26.00,3264,2448,26,93
photo-33.jpg,1,1380,1406,545,637,$30.00,3264,2448,26,92
photo-33.jpg,1,1423,1450,545,636,$46.00,3264,2448,27,91
photo-33.jpg,1,1469,1495,543,636,$36.65,3264,2448,26,93
photo-33.jpg,1,1514,1540,544,636,$32.00,3264,2448,26,92
photo-33.jpg,3,1199,1218,347,396,FRE,3264,2448,19,49
photo-33.jpg,1,1247,1270,1939,1972,15,3264,2448,23,33
photo-33.jpg,3,1244,1264,348,397,FRE,3264,2448,20,49
photo-33.jpg,1,1292,1314,1940,1954,1,3264,2448,22,14
photo-33.jpg,3,1288,1309,346,396,FRE,3264,2448,21,50
photo-33.jpg,1,1337,1359,1941,1954,1,3264,2448,22,13
photo-33.jpg,3,1333,1354,345,394,FRE,3264,2448,21,49
photo-33.jpg,1,1381,1403,1939,1971,15,3264,2448,22,32
photo-33.jpg,3,1378,1398,344,392,FRE,3264,2448,20,48
photo-33.jpg,1,1426,1448,1942,1955,1,3264,2448,22,13
photo-33.jpg,3,1422,1442,343,393,FRE,3264,2448,20,50
photo-33.jpg,1,1469,1493,1940,2035,25.465,3264,2448,24,95
photo-33.jpg,3,1467,1487,343,392,FRE,3264,2448,20,49
photo-33.jpg,1,1515,1538,1943,1957,1,3264,2448,23,14
photo-33.jpg,3,1512,1532,343,392,FRE,3264,2448,20,49
photo-34.jpg,2,1199,1232,1342,1689,Pinldadys - Special Carton,3264,2448,33,347
photo-34.jpg,2,1242,1273,1331,1688,Bananas • Cavendish 15kg,3264,2448,31,357
photo-34.jpg,2,1288,1318,1348,1688,Mandarins - Large Carton,3264,2448,30,340
photo-34.jpg,2,1331,1366,1370,1688,Pineapples Xlarge Each,3264,2448,35,318
photo-34.jpg,2,1373,1410,1259,1687,Strawbenys - 5OOgm 2nd Grade,3264,2448,37,428
photo-34.jpg,2,1421,1450,1377,1685,Watermelon - Seedless,3264,2448,29,308
photo-34.jpg,2,1462,1495,1292,1685,Cucumbers - Continental Bag,3264,2448,33,393
photo-34.jpg,2,1511,1539,1445,1685,Sweetcom Carton,3264,2448,28,240
photo-34.jpg,2,1553,1586,1302,1685,Mesculin 3kg Qld Mix Carton,3264,2448,33,383
photo-34.jpg,3,1175,1197,400,452,FRE,3264,2448,22,52
photo-34.jpg,1,1182,1211,602,697,$30.00,3264,2448,29,95
photo-34.jpg,1,1226,1255,600,695,$20.00,3264,2448,29,95
photo-34.jpg,1,1270,1299,599,696,$52.00,3264,2448,29,97
photo-34.jpg,1,1316,1344,598,694,$30.00,3264,2448,28,96
photo-34.jpg,1,1359,1388,596,691,$28.00,3264,2448,29,95
photo-34.jpg,1,1403,1432,598,690,$64.01,3264,2448,29,92
photo-34.jpg,1,1448,1477,593,688,$20.00,3264,2448,29,95
photo-34.jpg,1,1493,1522,592,688,$56.00,3264,2448,29,96
photo-34.jpg,1,1538,1565,590,686,$32.00,3264,2448,27,96
photo-34.jpg,1,1189,1217,944,1038,$30.00,3264,2448,28,94
photo-34.jpg,1,1233,1261,944,1037,$20.00,3264,2448,28,93
photo-34.jpg,1,1277,1305,942,1036,$52.00,3264,2448,28,94
photo-34.jpg,1,1322,1350,950,1027,$2.50,3264,2448,28,77
photo-34.jpg,1,1366,1394,948,1025,33.50,3264,2448,28,77
photo-34.jpg,1,1410,1439,948,1025,$1.25,3264,2448,29,77
photo-34.jpg,1,1455,1483,938,1031,$20.00,3264,2448,28,93
photo-34.jpg,1,1500,1528,936,1030,$28.00,3264,2448,28,94
photo-34.jpg,1,1545,1572,935,1029,$32.00,3264,2448,27,94
photo-34.jpg,1,1210,1234,1981,1995,1,3264,2448,24,14
photo-34.jpg,3,1206,1233,1791,1886,FA 130,3264,2448,27,95
photo-34.jpg,3,1250,1277,1790,1886,FB 110,3264,2448,27,96
photo-34.jpg,3,1294,1321,1789,1889,FM 101,3264,2448,27,100
photo-34.jpg,3,1338,1366,1788,1887,FP 109,3264,2448,28,99
photo-34.jpg,3,1382,1409,1787,1886,FS 102,3264,2448,27,99
photo-34.jpg,3,1426,1454,1784,1890,FW102,3264,2448,28,106
photo-34.jpg,3,1471,1498,1788,1887,VC 118,3264,2448,27,99
photo-34.jpg,3,1515,1543,1786,1889,VS 105,3264,2448,28,103
photo-34.jpg,3,1561,1588,1780,1891,MM 109,3264,2448,27,111
photo-34.jpg,3,1219,1242,398,451,FRE,3264,2448,23,53
photo-34.jpg,1,1254,1279,1982,1994,1,3264,2448,25,12
photo-34.jpg,3,1264,1286,397,449,FRE,3264,2448,22,52
photo-34.jpg,1,1298,1323,1980,1994,1,3264,2448,25,14
photo-34.jpg,3,1308,1330,395,448,FRE,3264,2448,22,53
photo-34.jpg,1,1342,1367,1977,2011,12,3264,2448,25,34
photo-34.jpg,3,1353,1374,394,445,FRE,3264,2448,21,51
photo-34.jpg,1,1386,1411,1976,1996,8,3264,2448,25,20
photo-34.jpg,3,1398,1419,394,444,FRE,3264,2448,21,50
photo-34.jpg,1,1431,1456,1975,2072,51.205,3264,2448,25,97
photo-34.jpg,3,1443,1463,392,442,FRE,3264,2448,20,50
photo-34.jpg,1,1477,1500,1979,1994,1,3264,2448,23,15
photo-34.jpg,3,1486,1509,389,442,FRE,3264,2448,23,53
photo-34.jpg,1,1519,1545,1976,1996,2,3264,2448,26,20
photo-34.jpg,3,1532,1554,388,440,FRE,3264,2448,22,52
photo-34.jpg,1,1566,1590,1979,1993,1,3264,2448,24,14
photo-35.jpg,2,1146,1176,1284,1673,Cucumbers - Continental Bag,3264,2448,30,389
photo-35.jpg,2,1190,1220,1325,1673,Tomatoes - Cherry Punnet,3264,2448,30,348
photo-35.jpg,2,1233,1262,1294,1673,Potatoes - White Chats 20kg,3264,2448,29,379
photo-35.jpg,3,1124,1146,393,445,FRE,3264,2448,22,52
photo-35.jpg,1,1132,1158,594,686,$24.00,3264,2448,26,92
photo-35.jpg,1,1175,1202,593,685,$30.00,3264,2448,27,92
photo-35.jpg,1,1219,1246,590,683,$56.50,3264,2448,27,93
photo-35.jpg,1,1138,1165,933,1028,$24.00,3264,2448,27,95
photo-35.jpg,1,1182,1209,942,1019,$2.00,3264,2448,27,77
photo-35.jpg,1,1224,1252,932,1026,$56.50,3264,2448,28,94
photo-35.jpg,1,1157,1180,1963,1978,1,3264,2448,23,15
photo-35.jpg,3,1152,1178,1773,1872,VC 118,3264,2448,26,99
photo-35.jpg,3,1196,1222,1775,1871,VT105,3264,2448,26,96
photo-35.jpg,3,1240,1265,1772,1869,PP 106,3264,2448,25,97
photo-35.jpg,3,1168,1190,391,444,FRE,3264,2448,22,53
photo-35.jpg,1,1200,1223,1961,1994,15,3264,2448,23,33
photo-35.jpg,3,1212,1234,391,442,FRE,3264,2448,22,51
photo-35.jpg,1,1243,1265,1965,1978,1,3264,2448,22,13
photo-37.jpg,2,1310,1346,1480,1998,IK(10) SMOKED SALMON PIECES,3264,2448,36,518
photo-37.jpg,2,1347,1387,1308,1998,*#1K(6) FRZ F/P SIiC OVN/RST CHK/MSAT,3264,2448,40,690
photo-37.jpg,2,1391,1428,1478,1999,7K JAPANESE BREADCRUMBS HOA,3264,2448,37,521
photo-37.jpg,2,1430,1470,1382,1998,IK(6) GREEN/BROWN LENTILS TRUMPS,3264,2448,40,616
photo-37.jpg,2,1475,1511,1516,1996,10K GP COARSE BREADCRUMBS,3264,2448,36,480
photo-37.jpg,2,1512,1553,1397,1998,R/W PRS MED CKD TIGER PRAWN W.A,3264,2448,41,601
photo-37.jpg,1,1365,1393,2074,2189,090993,3264,2448,28,115
photo-37.jpg,1,1406,1435,2071,2188,021208,3264,2448,29,117
photo-37.jpg,1,1448,1475,2070,2187,094748,3264,2448,27,117
photo-37.jpg,1,1490,1519,2069,2187,203085,3264,2448,29,118
photo-37.jpg,1,1531,1560,2068,2187,205557,3264,2448,29,119
photo-37.jpg,1,1284,1309,613,707,13.80,3264,2448,25,94
photo-37.jpg,1,1325,1348,612,705,13.80,3264,2448,23,93
photo-37.jpg,1,1365,1388,611,704,24.51,3264,2448,23,93
photo-37.jpg,1,1406,1430,608,683,4.59,3264,2448,24,75
photo-37.jpg,1,1448,1471,606,700,27.94,3264,2448,23,94
photo-37.jpg,1,1488,1513,606,698,24.37,3264,2448,25,92
photo-37.jpg,1,1279,1302,477,555,0.00,3264,2448,23,78
photo-37.jpg,1,1319,1343,477,553,0.00,3264,2448,24,76
photo-37.jpg,1,1359,1384,474,551,0.00,3264,2448,25,77
photo-37.jpg,1,1401,1426,473,548,0.00,3264,2448,25,75
photo-37.jpg,1,1442,1467,471,547,0.00,3264,2448,25,76
photo-37.jpg,1,1483,1509,468,544,0.00,3264,2448,26,76
photo-37.jpg,3,1306,1328,1163,1201,EA,3264,2448,22,38
photo-37.jpg,1,1300,1323,981,1057,4.00,3264,2448,23,76
photo-37.jpg,1,1341,1364,981,1056,4.00,3264,2448,23,75
photo-37.jpg,1,1382,1405,980,1053,1.00,3264,2448,23,73
photo-37.jpg,1,1423,1446,977,1052,6.00,3264,2448,23,75
photo-37.jpg,1,1464,1487,976,1050,1.00,3264,2448,23,74
photo-37.jpg,1,1505,1530,974,1067,10.00,3264,2448,25,93
photo-37.jpg,1,1294,1317,794,868,4.00,3264,2448,23,74
photo-37.jpg,1,1334,1358,793,867,4.00,3264,2448,24,74
photo-37.jpg,1,1375,1398,793,865,1.00,3264,2448,23,72
photo-37.jpg,1,1417,1440,790,863,6.00,3264,2448,23,73
photo-37.jpg,1,1457,1481,788,861,1.00,3264,2448,24,73
photo-37.jpg,1,1499,1524,787,879,10.00,3264,2448,25,92
photo-37.jpg,1,1272,1297,278,373,55.19,3264,2448,25,95
photo-37.jpg,3,1348,1368,1162,1201,EA,3264,2448,20,39
photo-37.jpg,1,1313,1338,277,371,55.20,3264,2448,25,94
photo-37.jpg,1,1354,1379,275,371,24.51,3264,2448,25,96
photo-37.jpg,1,1385,1420,260,367,27.521,3264,2448,35,107
photo-37.jpg,1,1437,1461,272,366,27.94,3264,2448,24,94
photo-37.jpg,3,1457,1504,257,384,243.7l|,3264,2448,47,127
photo-37.jpg,3,1388,1409,1161,1199,EA,3264,2448,21,38
photo-37.jpg,3,1434,1450,1160,1197,ea,3264,2448,16,37
photo-37.jpg,3,1471,1491,1158,1195,EA,3264,2448,20,37
photo-37.jpg,3,1511,1533,1156,1196,KG,3264,2448,22,40
photo-38.jpg,2,1343,1376,1409,2037,2.15K(6) CHILLI TOMATO JAM KNORR,3264,2448,33,628
photo-38.jpg,2,1387,1418,1485,2037,25(6) STL LEMON T/BAG LIPTON,3264,2448,31,552
photo-38.jpg,2,1425,1460,1330,2034,*25(6) STL JASMINE GREEN T/BAG LIPTO,3264,2448,35,704
photo-38.jpg,2,1469,1501,1386,2034,*1L(6) HOLLANDAISE SCE GARDE D'OR,3264,2448,32,648
photo-38.jpg,2,1510,1545,1346,2035,2.IK(6) PROFESS MONGOLIAN SCE KNORR,3264,2448,35,689
photo-38.jpg,2,1555,1585,1542,2033,750GX2 PUREE GARLIC KNORR,3264,2448,30,491
photo-38.jpg,2,1593,1628,1347,2031,*2.3K (2 ) WHOLEGRAIN MUSTARD COLMANS,3264,2448,35,684
photo-38.jpg,2,1636,1672,1385,2030,*500 ENVELOPE TEACUP BAG BUSHELLS,3264,2448,36,645
photo-38.jpg,2,1678,1714,1325,2031,850G(6) THAI GREEN CURRY PASTE KNORR,3264,2448,36,706
photo-38.jpg,2,1722,1759,1423,2031,2K(6) CHINESE SWEET SOUR SAKIMS,3264,2448,37,608
photo-38.jpg,2,1763,1798,1384,2030,2.05K(6) CHINESE LEMON SCE SAKIMS,3264,2448,35,646
photo-38.jpg,2,1808,1841,1461,2029,*2.9K(2) MANGO CHUTNEY PATAKS,3264,2448,33,568
photo-38.jpg,1,1352,1376,2113,2231,013660,3264,2448,24,118
photo-38.jpg,1,1394,1418,2111,2232,015234,3264,2448,24,121
photo-38.jpg,1,1437,1460,2111,2231,015235,3264,2448,23,120
photo-38.jpg,1,1479,1504,2110,2231,029428,3264,2448,25,121
photo-38.jpg,1,1521,1545,2111,2230,029802,3264,2448,24,119
photo-38.jpg,1,1564,1589,2110,2229,062289,3264,2448,25,119
photo-38.jpg,1,1607,1631,2109,2228,075194,3264,2448,24,119
photo-38.jpg,1,1649,1675,2108,2228,076769,3264,2448,26,120
photo-38.jpg,1,1693,1718,2108,2227,076984,3264,2448,25,119
photo-38.jpg,1,1735,1760,2107,2227,079675,3264,2448,25,120
photo-38.jpg,1,1778,1802,2108,2226,089833,3264,2448,24,118
photo-38.jpg,1,1820,1846,2107,2225,092512,3264,2448,26,118
photo-38.jpg,1,1329,1353,628,719,13.62,3264,2448,24,91
photo-38.jpg,1,1370,1394,627,701,3.98,3264,2448,24,74
photo-38.jpg,1,1412,1435,625,701,3.98,3264,2448,23,76
photo-38.jpg,1,1454,1478,625,699,9.65,3264,2448,24,74
photo-38.jpg,1,1495,1519,624,716,13.48,3264,2448,24,92
photo-38.jpg,1,1537,1561,624,715,18.80,3264,2448,24,91
photo-38.jpg,1,1578,1602,623,714,14.32,3264,2448,24,91
photo-38.jpg,1,1622,1646,622,717,25.92,3264,2448,24,95
photo-38.jpg,1,1663,1688,621,714,15.75,3264,2448,25,93
photo-38.jpg,1,1705,1730,621,713,13.48,3264,2448,25,92
photo-38.jpg,1,1747,1771,620,711,13.47,3264,2448,24,91
photo-38.jpg,1,1789,1813,618,711,27.81,3264,2448,24,93
photo-38.jpg,1,1327,1350,492,565,0.00,3264,2448,23,73
photo-38.jpg,1,1368,1393,492,565,0.00,3264,2448,25,73
photo-38.jpg,1,1410,1434,490,565,0.00,3264,2448,24,75
photo-38.jpg,1,1450,1477,490,564,0.00,3264,2448,27,74
photo-38.jpg,1,1492,1518,489,563,0.00,3264,2448,26,74
photo-38.jpg,1,1534,1559,488,561,0.00,3264,2448,25,73
photo-38.jpg,1,1575,1600,487,560,0.00,3264,2448,25,73
photo-38.jpg,1,1619,1644,486,561,0.00,3264,2448,25,75
photo-38.jpg,1,1661,1685,486,560,0.00,3264,2448,24,74
photo-38.jpg,1,1702,1727,486,559,0.00,3264,2448,25,73
photo-38.jpg,1,1744,1768,484,557,0.00,3264,2448,24,73
photo-38.jpg,1,1786,1810,483,556,0.00,3264,2448,24,73
photo-38.jpg,1,1322,1346,293,385,27.24,3264,2448,24,92
photo-38.jpg,1,1363,1388,292,367,7.96,3264,2448,25,75
photo-38.jpg,1,1405,1429,291,366,7.96,3264,2448,24,75
photo-38.jpg,1,1446,1471,290,384,19.30,3264,2448,25,94
photo-38.jpg,1,1489,1512,291,382,40.44,3264,2448,23,91
photo-38.jpg,1,1529,1555,289,381,18.80,3264,2448,26,92
photo-38.jpg,1,1572,1596,289,379,14.32,3264,2448,24,90
photo-38.jpg,1,1615,1640,287,380,51.84,3264,2448,25,93
photo-38.jpg,1,1656,1681,286,379,31.50,3264,2448,25,93
photo-38.jpg,1,1698,1722,286,379,40.44,3264,2448,24,93
photo-38.jpg,1,1740,1764,284,378,40.41,3264,2448,24,94
photo-38.jpg,1,1781,1806,282,378,27.81,3264,2448,25,96
photo-38.jpg,3,1347,1367,1183,1221,EA,3264,2448,20,38
photo-38.jpg,1,1341,1366,1001,1076,2.00,3264,2448,25,75
photo-38.jpg,1,1383,1407,1001,1075,2.00,3264,2448,24,74
photo-38.jpg,1,1424,1448,1000,1074,2.00,3264,2448,24,74
photo-38.jpg,1,1466,1491,999,1074,2.00,3264,2448,25,75
photo-38.jpg,1,1508,1532,998,1072,3.00,3264,2448,24,74
photo-38.jpg,1,1549,1574,998,1071,1.00,3264,2448,25,73
photo-38.jpg,1,1591,1616,997,1069,1.00,3264,2448,25,72
photo-38.jpg,1,1635,1659,997,1070,2.00,3264,2448,24,73
photo-38.jpg,1,1677,1701,995,1071,2.00,3264,2448,24,76
photo-38.jpg,1,1719,1743,994,1068,3.00,3264,2448,24,74
photo-38.jpg,1,1760,1785,993,1068,3.00,3264,2448,25,75
photo-38.jpg,1,1802,1827,992,1066,1.00,3264,2448,25,74
photo-38.jpg,1,1338,1361,812,885,2.00,3264,2448,23,73
photo-38.jpg,1,1379,1404,812,885,2.00,3264,2448,25,73
photo-38.jpg,1,1420,1445,810,884,2.00,3264,2448,25,74
photo-38.jpg,1,1463,1487,809,884,2.00,3264,2448,24,75
photo-38.jpg,1,1504,1529,808,882,3.00,3264,2448,25,74
photo-38.jpg,1,1546,1571,807,880,1.00,3264,2448,25,73
photo-38.jpg,1,1588,1612,807,879,1.00,3264,2448,24,72
photo-38.jpg,1,1631,1656,807,880,2.00,3264,2448,25,73
photo-38.jpg,1,1673,1697,806,880,2.00,3264,2448,24,74
photo-38.jpg,1,1714,1739,805,878,3.00,3264,2448,25,73
photo-38.jpg,1,1756,1780,804,877,3.00,3264,2448,24,73
photo-38.jpg,1,1798,1822,803,876,1.00,3264,2448,24,73
photo-38.jpg,3,1388,1409,1181,1220,EA,3264,2448,21,39
photo-38.jpg,3,1429,1451,1182,1219,EA,3264,2448,22,37
photo-38.jpg,3,1472,1494,1179,1219,EA,3264,2448,22,40
photo-38.jpg,3,1513,1535,1178,1217,EA,3264,2448,22,39
photo-38.jpg,3,1555,1577,1179,1217,EA,3264,2448,22,38
photo-38.jpg,3,1596,1618,1177,1215,EA,3264,2448,22,38
photo-38.jpg,3,1641,1662,1177,1216,EA,3264,2448,21,39
photo-38.jpg,3,1681,1703,1176,1216,EA,3264,2448,22,40
photo-38.jpg,3,1724,1745,1175,1214,BA,3264,2448,21,39
photo-38.jpg,3,1766,1787,1175,1213,EA,3264,2448,21,38
photo-38.jpg,3,1808,1830,1174,1211,EA,3264,2448,22,37
photo-39.jpg,2,1323,1353,1450,2015,*6PKX5 GOLDEN PANCAKE TIP TOP,3264,2448,30,565
photo-39.jpg,2,1361,1397,1316,2017,*2.5K{2) R/L MID/RASH BACON KR CASTL,3264,2448,36,701
photo-39.jpg,2,1404,1439,1417,2017,R/W FRS BFM SOLAR BLADE 5-6K(3),3264,2448,35,600
photo-39.jpg,2,1445,1480,1428,2014,15K TUSCANY CHOC CHIPS CADBURY,3264,2448,35,586
photo-39.jpg,2,1486,1522,1371,2012,*500 ENVELOPE TEACUP BAG BUSHELLS,3264,2448,36,641
photo-39.jpg,1,1297,1323,302,393,55.54,3264,2448,26,91
photo-39.jpg,1,1337,1365,302,394,99.60,3264,2448,28,92
photo-39.jpg,1,1378,1406,299,410,264.28,3264,2448,28,111
photo-39.jpg,1,1419,1446,298,390,87.59,3264,2448,27,92
photo-39.jpg,1,1460,1487,299,389,25.92,3264,2448,27,90
photo-39.jpg,1,1301,1327,496,569,5.05,3264,2448,26,73
photo-39.jpg,1,1305,1331,629,720,16.83,3264,2448,26,91
photo-39.jpg,1,1345,1373,626,721,24.90,3264,2448,28,95
photo-39.jpg,1,1313,1340,807,881,3.00,3264,2448,27,74
photo-39.jpg,1,1317,1343,993,1068,3.00,3264,2448,26,75
photo-39.jpg,1,1358,1385,991,1068,4.00,3264,2448,27,77
photo-39.jpg,1,1400,1425,989,1084,29.00,3264,2448,25,95
photo-39.jpg,1,1441,1467,989,1062,1.00,3264,2448,26,73
photo-39.jpg,1,1480,1507,988,1063,1.00,3264,2448,27,75
photo-39.jpg,3,1324,1346,1172,1211,BA,3264,2448,22,39
photo-39.jpg,1,1330,1355,2092,2212,076209,3264,2448,25,120
photo-39.jpg,1,1372,1398,2090,2211,030051,3264,2448,26,121
photo-39.jpg,1,1414,1441,2089,2210,037639,3264,2448,27,121
photo-39.jpg,1,1456,1483,2090,2209,019527,3264,2448,27,119
photo-39.jpg,1,1499,1525,2088,2208,076769,3264,2448,26,120
photo-39.jpg,1,1342,1369,495,569,0.00,3264,2448,27,74
photo-39.jpg,1,1383,1410,492,568,0.00,3264,2448,27,76
photo-39.jpg,1,1423,1451,491,567,0.00,3264,2448,28,76
photo-39.jpg,1,1464,1492,492,565,0.00,3264,2448,28,73
photo-39.jpg,1,1354,1382,806,881,4.00,3264,2448,28,75
photo-39.jpg,1,1395,1423,804,898,31.65,3264,2448,28,94
photo-39.jpg,3,1366,1387,1170,1211,EA,3264,2448,21,41
photo-39.jpg,1,1386,1412,626,701,8.35,3264,2448,26,75
photo-39.jpg,3,1406,1428,1170,1210,KG,3264,2448,22,40
photo-39.jpg,1,1428,1455,624,717,87.59,3264,2448,27,93
photo-39.jpg,1,1469,1495,625,717,25.92,3264,2448,26,92
photo-39.jpg,1,1437,1463,804,876,1.00,3264,2448,26,72
photo-39.jpg,3,1448,1469,1167,1206,EA,3264,2448,21,39
photo-39.jpg,1,1478,1505,802,876,1.00,3264,2448,27,74
photo-39.jpg,3,1488,1511,1166,1207,EA,3264,2448,23,41
photo-40.jpg,2,1347,1377,1309,1986,*1.5K(6) PEARL COOS COUS VEG EDGELL,3264,2448,30,677
photo-40.jpg,2,1389,1417,1289,1990,COLES EXP FZNX6 HAM CHEESE CROISSANT,3264,2448,28,701
photo-40.jpg,2,1430,1460,1289,1988,5006(7) G/FREE PLAIN FLOOR A/PURPOSE,3264,2448,30,699
photo-40.jpg,2,1471,1502,1347,1988,*#A10(3) SLICED BEETROOT G/CIRCLE,3264,2448,31,641
photo-40.jpg,2,1513,1543,1348,1993,A10(3) SLC PINEAPPLE THIN L/S SPC,3264,2448,30,645
photo-40.jpg,2,1555,1585,1289,1990,2L(6) LIME MINT JULEP CORDIAL SHINGL,3264,2448,30,701
photo-40.jpg,1,1333,1356,248,327,0.00,3264,2448,23,79
photo-40.jpg,1,1374,1398,248,344,22.48,3264,2448,24,96
photo-40.jpg,1,1416,1441,241,324,9.831,3264,2448,25,83
photo-40.jpg,1,1458,1482,246,324,7.98,3264,2448,24,78
photo-40.jpg,1,1500,1524,244,342,10.29,3264,2448,24,98
photo-40.jpg,1,1544,1568,244,322,0.00,3264,2448,24,78
photo-40.jpg,1,1353,1376,2061,2178,212124,3264,2448,23,117
photo-40.jpg,1,1394,1417,2061,2178,970046,3264,2448,23,117
photo-40.jpg,1,1435,1459,2063,2179,034593,3264,2448,24,116
photo-40.jpg,1,1476,1500,2061,2179,041478,3264,2448,24,118
photo-40.jpg,1,1518,1542,2063,2179,058586,3264,2448,24,116
photo-40.jpg,1,1561,1585,2064,2180,071463,3264,2448,24,116
photo-40.jpg,1,1335,1360,452,528,0.00,3264,2448,25,76
photo-40.jpg,1,1377,1401,452,528,2.04,3264,2448,24,76
photo-40.jpg,1,1420,1443,450,527,0.00,3264,2448,23,77
photo-40.jpg,1,1462,1485,450,527,0.00,3264,2448,23,77
photo-40.jpg,1,1504,1529,449,525,0.00,3264,2448,25,76
photo-40.jpg,1,1546,1571,448,524,0.00,3264,2448,25,76
photo-40.jpg,1,1337,1362,587,682,10.84,3264,2448,25,95
photo-40.jpg,1,1380,1404,587,682,20.44,3264,2448,24,95
photo-40.jpg,1,1422,1445,586,663,2.46,3264,2448,23,77
photo-40.jpg,1,1463,1488,586,662,7.98,3264,2448,25,76
photo-40.jpg,3,1505,1530,585,679,10 .-29,3264,2448,25,94
photo-40.jpg,1,1549,1573,585,679,10.47,3264,2448,24,94
photo-40.jpg,1,1347,1371,961,1036,6.00,3264,2448,24,75
photo-40.jpg,1,1389,1413,961,1036,1.00,3264,2448,24,75
photo-40.jpg,1,1431,1454,961,1036,4.00,3264,2448,23,75
photo-40.jpg,1,1473,1496,959,1035,1.00,3264,2448,23,76
photo-40.jpg,1,1514,1539,959,1035,1.00,3264,2448,25,76
photo-40.jpg,1,1557,1581,960,1035,1.00,3264,2448,24,75
photo-40.jpg,3,1346,1369,769,944,NOT AVAIL,3264,2448,23,175
photo-40.jpg,1,1386,1411,771,845,1.00,3264,2448,25,74
photo-40.jpg,1,1428,1453,770,847,4.00,3264,2448,25,77
photo-40.jpg,1,1470,1495,770,845,1.00,3264,2448,25,75
photo-40.jpg,1,1512,1538,769,845,1.00,3264,2448,26,76
photo-40.jpg,3,1556,1581,767,944,NOT AVAIL,3264,2448,25,177
photo-40.jpg,3,1351,1372,1142,1180,EA,3264,2448,21,38
photo-40.jpg,3,1393,1415,1141,1182,EA,3264,2448,22,41
photo-40.jpg,3,1435,1456,1142,1181,EA,3264,2448,21,39
photo-40.jpg,3,1478,1498,1140,1181,EA,3264,2448,20,41
photo-40.jpg,3,1519,1540,1140,1180,EA,3264,2448,21,40
photo-40.jpg,3,1561,1583,1141,1180,EA,3264,2448,22,39
photo-41.jpg,2,1421,1452,1340,1993,*#100GX63 P/CKD BEEF PATTIE ANG/BAY,3264,2448,31,653
photo-41.jpg,2,1463,1491,1396,1993,175GX12 G/FREE BEEF PIE MRS MACS,3264,2448,28,597
photo-41.jpg,2,1501,1532,1338,1993,140GX18 G/FREE BEEF VEGE ROLL MRS/M,3264,2448,31,655
photo-41.jpg,2,1542,1576,1319,1994,1L(12) F/CRM MILK LACTOSE FREE LIDDE,3264,2448,34,675
photo-41.jpg,2,1586,1616,1522,1991,*P/C 50(6) PLUM JAM ZOOSH,3264,2448,30,469
photo-41.jpg,1,1408,1434,325,414,70.04,3264,2448,26,89
photo-41.jpg,1,1448,1474,323,414,72.27,3264,2448,26,91
photo-41.jpg,1,1488,1514,323,411,84.24,3264,2448,26,88
photo-41.jpg,1,1528,1555,322,411,26.71,3264,2448,27,89
photo-41.jpg,1,1412,1438,647,737,70.04,3264,2448,26,90
photo-41.jpg,1,1452,1479,645,736,32.85,3264,2448,27,91
photo-41.jpg,1,1492,1518,645,734,39.20,3264,2448,26,89
photo-41.jpg,1,1532,1558,644,716,2.23,3264,2448,26,72
photo-41.jpg,1,1573,1598,642,714,4.75,3264,2448,25,72
photo-41.jpg,1,1410,1436,516,587,0.00,3264,2448,26,71
photo-41.jpg,1,1450,1477,515,587,8.87,3264,2448,27,72
photo-41.jpg,1,1490,1517,514,587,7.84,3264,2448,27,73
photo-41.jpg,1,1529,1557,513,585,0.00,3264,2448,28,72
photo-41.jpg,1,1571,1597,511,584,0.00,3264,2448,26,73
photo-41.jpg,1,1428,1452,2067,2181,081204,3264,2448,24,114
photo-41.jpg,1,1468,1492,2066,2182,212590,3264,2448,24,116
photo-41.jpg,1,1509,1533,2065,2181,212591,3264,2448,24,116
photo-41.jpg,1,1550,1575,2067,2180,021300,3264,2448,25,113
photo-41.jpg,1,1592,1616,2065,2179,088516,3264,2448,24,114
photo-41.jpg,1,1421,1445,1005,1076,1.00,3264,2448,24,71
photo-41.jpg,1,1462,1486,1003,1075,2.00,3264,2448,24,72
photo-41.jpg,1,1502,1526,1003,1075,2.00,3264,2448,24,72
photo-41.jpg,1,1543,1568,1002,1092,12.00,3264,2448,25,90
photo-41.jpg,1,1585,1608,1000,1073,2.00,3264,2448,23,73
photo-41.jpg,1,1419,1444,824,893,1.00,3264,2448,25,69
photo-41.jpg,1,1459,1485,823,894,2.00,3264,2448,26,71
photo-41.jpg,3,1500,1537,816,893,2.00j,3264,2448,37,77
photo-41.jpg,1,1540,1567,820,910,12.00,3264,2448,27,90
photo-41.jpg,1,1581,1606,819,891,2.00,3264,2448,25,72
photo-41.jpg,3,1426,1447,1178,1215,EA,3264,2448,21,37
photo-41.jpg,3,1467,1487,1177,1214,EA,3264,2448,20,37
photo-41.jpg,3,1506,1528,1177,1214,EA,3264,2448,22,37
photo-41.jpg,3,1547,1569,1176,1213,EA,3264,2448,22,37
photo-41.jpg,1,1569,1595,321,391,9.51,3264,2448,26,70
photo-41.jpg,3,1589,1610,1174,1211,EA,3264,2448,21,37
photo-42.jpg,2,1364,1403,1482,2035,*#10L VANILLA ICE CREAM BULLA,3264,2448,39,553
photo-42.jpg,2,1401,1445,1349,2034,3K(5) 100% ANGUS BEEF LASAGNE A/CHEF,3264,2448,44,685
photo-42.jpg,2,1448,1484,1536,2032,100MLX30 I/C SLICES PETERS,3264,2448,36,496
photo-42.jpg,2,1484,1526,1365,2030,*#2K(6) SPICY BATTERED WEDGE EDGELL,3264,2448,42,665
photo-42.jpg,2,1524,1567,1363,2029,*#48 GARLIC BREAD SPLIT LA/FAMIGLIA,3264,2448,43,666
photo-42.jpg,2,1568,1611,1400,2030,2K(6) HASH BROWN TRIANGLES MCCAIN,3264,2448,43,630
photo-42.jpg,2,1606,1650,1342,2027,*2.5K(2) R/L MID/RASH BACON KR CASTL,3264,2448,44,685
photo-42.jpg,1,1324,1350,324,419,42.79,3264,2448,26,95
photo-42.jpg,1,1365,1392,322,437,195.09,3264,2448,27,115
photo-42.jpg,1,1406,1432,320,416,49.90,3264,2448,26,96
photo-42.jpg,3,1448,1475,312,413,"81.78,",3264,2448,27,101
photo-42.jpg,1,1489,1516,317,414,70.58,3264,2448,27,97
photo-42.jpg,1,1532,1557,316,412,40.10,3264,2448,25,96
photo-42.jpg,1,1573,1600,315,430,204.89,3264,2448,27,115
photo-42.jpg,1,1331,1358,525,600,3.89,3264,2448,27,75
photo-42.jpg,1,1372,1400,523,616,17.74,3264,2448,28,93
photo-42.jpg,1,1414,1439,522,597,4.54,3264,2448,25,75
photo-42.jpg,1,1455,1482,519,594,0.00,3264,2448,27,75
photo-42.jpg,1,1497,1523,518,592,0.00,3264,2448,26,74
photo-42.jpg,1,1539,1566,516,592,0.00,3264,2448,27,76
photo-42.jpg,1,1580,1607,517,591,0.00,3264,2448,27,74
photo-42.jpg,1,1337,1361,659,751,19.45,3264,2448,24,92
photo-42.jpg,1,1377,1404,658,749,17.74,3264,2448,27,91
photo-42.jpg,1,1419,1445,657,748,11.34,3264,2448,26,91
photo-42.jpg,1,1460,1486,655,728,6.82,3264,2448,26,73
photo-42.jpg,1,1501,1529,654,744,35.29,3264,2448,28,90
photo-42.jpg,1,1544,1569,652,725,6.68,3264,2448,25,73
photo-42.jpg,1,1585,1610,649,743,25.61,3264,2448,25,94
photo-42.jpg,1,1381,1407,2108,2223,017395,3264,2448,26,115
photo-42.jpg,1,1421,1450,2107,2223,035986,3264,2448,29,116
photo-42.jpg,1,1463,1490,2105,2222,062825,3264,2448,27,117
photo-42.jpg,1,1503,1532,2103,2220,076400,3264,2448,29,117
photo-42.jpg,1,1545,1573,2104,2218,080203,3264,2448,28,114
photo-42.jpg,1,1588,1615,2102,2217,212336,3264,2448,27,115
photo-42.jpg,1,1629,1655,2101,2215,030051,3264,2448,26,114
photo-42.jpg,1,1348,1373,840,912,2.00,3264,2448,25,72
photo-42.jpg,1,1388,1414,838,930,10.00,3264,2448,26,92
photo-42.jpg,1,1430,1455,834,909,4.00,3264,2448,25,75
photo-42.jpg,1,1471,1497,834,925,12.00,3264,2448,26,91
photo-42.jpg,3,1494,1538,829,907,2. Oo!,3264,2448,44,78
photo-42.jpg,1,1554,1580,832,905,6.00,3264,2448,26,73
photo-42.jpg,1,1597,1621,830,903,8.00,3264,2448,24,73
photo-42.jpg,1,1354,1380,1026,1101,2.00,3264,2448,26,75
photo-42.jpg,1,1395,1421,1025,1118,10.00,3264,2448,26,93
photo-42.jpg,1,1436,1462,1022,1098,4.00,3264,2448,26,76
photo-42.jpg,1,1477,1503,1021,1114,12.00,3264,2448,26,93
photo-42.jpg,1,1518,1545,1019,1094,2.00,3264,2448,27,75
photo-42.jpg,1,1562,1587,1019,1092,6.00,3264,2448,25,73
photo-42.jpg,1,1603,1628,1018,1091,8.00,3264,2448,25,73
photo-42.jpg,3,1363,1385,1205,1243,EA,3264,2448,22,38
photo-42.jpg,3,1403,1426,1204,1242,EA,3264,2448,23,38
photo-42.jpg,3,1444,1466,1202,1240,EA,3264,2448,22,38
photo-42.jpg,3,1485,1508,1200,1238,EA,3264,2448,23,38
photo-42.jpg,3,1526,1549,1199,1237,EA,3264,2448,23,38
photo-42.jpg,3,1568,1591,1198,1236,EA,3264,2448,23,38
photo-42.jpg,3,1609,1632,1197,1235,EA,3264,2448,23,38
photo-43.jpg,2,1333,1369,1276,1937,*500(6) 1FLY WHT LUNCH SERVIETTE SIL,3264,2448,36,661
photo-43.jpg,2,1376,1410,1368,1939,1256(20) 'Water crackers Ahnotts,3264,2448,34,571
photo-43.jpg,2,1414,1449,1292,1937,"*#21,(6) 100% L/L APPLE JCE 6/CIRCLE",3264,2448,35,645
photo-43.jpg,2,1453,1489,1292,1936,*#2L(6) 100% L/L PINE JUICE HAS 6/C,3264,2448,36,644
photo-43.jpg,2,1493,1529,1272,1935,*#2L(6) 100% L/L ORANGE JCB 6/CIRCLE,3264,2448,36,663
photo-43.jpg,2,1538,1567,1493,1934,*#10K ARBORIO RICE EATEO,3264,2448,29,441
photo-43.jpg,1,1311,1336,278,368,53.22,3264,2448,25,90
photo-43.jpg,1,1350,1376,277,367,16.45,3264,2448,26,90
photo-43.jpg,1,1390,1416,276,364,40.92,3264,2448,26,88
photo-43.jpg,1,1430,1455,274,365,42.12,3264,2448,25,91
photo-43.jpg,1,1471,1496,271,364,38.45,3264,2448,25,93
photo-43.jpg,1,1511,1535,272,364,25.90,3264,2448,24,92
photo-43.jpg,1,1347,1370,2008,2119,050915,3264,2448,23,111
photo-43.jpg,1,1386,1411,2007,2120,061301,3264,2448,25,113
photo-43.jpg,1,1426,1450,2006,2119,078491,3264,2448,24,113
photo-43.jpg,1,1466,1489,2008,2118,078492,3264,2448,23,110
photo-43.jpg,1,1505,1531,2006,2118,097607,3264,2448,26,112
photo-43.jpg,1,1546,1571,2005,2117,212221,3264,2448,25,112
photo-43.jpg,1,1319,1342,604,675,4.03,3264,2448,23,71
photo-43.jpg,1,1359,1382,602,672,1.49,3264,2448,23,70
photo-43.jpg,1,1398,1422,599,671,3.41,3264,2448,24,72
photo-43.jpg,1,1438,1462,597,670,3.51,3264,2448,24,73
photo-43.jpg,1,1478,1503,597,670,3.20,3264,2448,25,73
photo-43.jpg,1,1518,1544,596,688,25.90,3264,2448,26,92
photo-43.jpg,1,1315,1338,472,544,4.84,3264,2448,23,72
photo-43.jpg,1,1355,1379,470,542,1.50,3264,2448,24,72
photo-43.jpg,1,1395,1418,470,540,0.00,3264,2448,23,70
photo-43.jpg,1,1435,1459,468,540,0.00,3264,2448,24,72
photo-43.jpg,1,1475,1499,466,539,0.00,3264,2448,24,73
photo-43.jpg,1,1515,1538,466,539,0.00,3264,2448,23,73
photo-43.jpg,1,1328,1352,781,870,12.00,3264,2448,24,89
photo-43.jpg,1,1368,1393,780,869,10.00,3264,2448,25,89
photo-43.jpg,1,1405,1432,776,868,12.00,3264,2448,27,92
photo-43.jpg,1,1448,1472,777,867,12.00,3264,2448,24,90
photo-43.jpg,1,1488,1511,776,866,12.00,3264,2448,23,90
photo-43.jpg,1,1527,1552,775,846,1.00,3264,2448,25,71
photo-43.jpg,1,1332,1356,963,1051,12.00,3264,2448,24,88
photo-43.jpg,1,1371,1397,962,1050,10.00,3264,2448,26,88
photo-43.jpg,1,1412,1436,959,1049,12.00,3264,2448,24,90
photo-43.jpg,1,1452,1475,958,1048,12.00,3264,2448,23,90
photo-43.jpg,1,1491,1514,958,1046,12.00,3264,2448,23,88
photo-43.jpg,1,1531,1555,957,1027,1.00,3264,2448,24,70
photo-43.jpg,3,1338,1358,1133,1171,EA,3264,2448,20,38
photo-43.jpg,3,1378,1398,1132,1170,EA,3264,2448,20,38
photo-43.jpg,3,1417,1438,1131,1169,EA,3264,2448,21,38
photo-43.jpg,3,1457,1477,1130,1168,BA,3264,2448,20,38
photo-43.jpg,3,1497,1516,1129,1167,EA,3264,2448,19,38
photo-43.jpg,3,1536,1557,1129,1167,EA,3264,2448,21,38
photo-44.jpg,2,1308,1334,1479,2040,*3101. VANILLA ICE CREAM BULLA,3264,2448,26,561
photo-44.jpg,2,1349,1376,1460,2040,*35K(3) FISH SHOP CHIPS MCCAIN,3264,2448,27,580
photo-44.jpg,2,1391,1420,1365,2041,*1K(10) MIXED BERRIES IQP G/SUPREME,3264,2448,29,676
photo-44.jpg,2,1432,1459,1482,2042,*6PKX5 GOLDEN PANCAKE TIP TOP,3264,2448,27,560
photo-44.jpg,2,1474,1501,1347,2043,*2.5K(2) R/L MID/RASH BACON KR CASTL,3264,2448,27,696
photo-44.jpg,1,1306,1329,2116,2232,017395,3264,2448,23,116
photo-44.jpg,1,1348,1371,2116,2234,052278,3264,2448,23,118
photo-44.jpg,1,1389,1412,2117,2234,062527,3264,2448,23,117
photo-44.jpg,1,1431,1454,2119,2237,076209,3264,2448,23,118
photo-44.jpg,1,1473,1495,2119,2235,030051,3264,2448,22,116
photo-44.jpg,1,1312,1335,309,403,42.79,3264,2448,23,94
photo-44.jpg,1,1355,1378,309,402,59.82,3264,2448,23,93
photo-44.jpg,1,1396,1420,308,403,34.34,3264,2448,24,95
photo-44.jpg,1,1438,1462,310,403,95.21,3264,2448,24,93
photo-44.jpg,1,1481,1504,310,422,128.06,3264,2448,23,112
photo-44.jpg,1,1312,1336,511,585,3.89,3264,2448,24,74
photo-44.jpg,1,1354,1378,510,584,0.00,3264,2448,24,74
photo-44.jpg,1,1396,1420,511,585,0.00,3264,2448,24,74
photo-44.jpg,1,1438,1463,512,584,8.66,3264,2448,25,72
photo-44.jpg,1,1480,1504,512,585,0.00,3264,2448,24,73
photo-44.jpg,1,1312,1335,647,737,19.45,3264,2448,23,90
photo-44.jpg,1,1354,1377,646,718,9.97,3264,2448,23,72
photo-44.jpg,1,1397,1419,646,719,8.58,3264,2448,22,73
photo-44.jpg,1,1438,1462,647,737,17.31,3264,2448,24,90
photo-44.jpg,1,1481,1503,647,739,25.61,3264,2448,22,92
photo-44.jpg,1,1317,1340,829,902,2.00,3264,2448,23,73
photo-44.jpg,1,1359,1382,828,901,6.00,3264,2448,23,73
photo-44.jpg,1,1401,1423,829,903,4.00,3264,2448,22,74
photo-44.jpg,1,1443,1466,830,903,5.00,3264,2448,23,73
photo-44.jpg,1,1485,1507,829,903,5.00,3264,2448,22,74
photo-44.jpg,1,1316,1339,1018,1091,2.00,3264,2448,23,73
photo-44.jpg,1,1358,1381,1017,1090,6.00,3264,2448,23,73
photo-44.jpg,1,1400,1422,1018,1092,4.00,3264,2448,22,74
photo-44.jpg,1,1441,1464,1019,1092,5.00,3264,2448,23,73
photo-44.jpg,1,1483,1505,1018,1092,5.00,3264,2448,22,74
photo-44.jpg,3,1318,1339,1198,1235,EA,3264,2448,21,37
photo-44.jpg,3,1360,1381,1198,1236,EA,3264,2448,21,38
photo-44.jpg,3,1402,1422,1198,1237,EA,3264,2448,20,39
photo-44.jpg,3,1443,1464,1200,1237,EA,3264,2448,21,37
photo-44.jpg,3,1485,1506,1199,1237,EA,3264,2448,21,38
photo-45.jpg,2,1335,1361,1415,1995,40GX125 CHOC CHIP COOKIE BABELS,3264,2448,26,580
photo-45.jpg,2,1374,1402,1320,1995,3K(5) 100% ANGUS BEEF LASAGNE A/CHEF,3264,2448,28,675
photo-45.jpg,2,1415,1442,1433,1994,*§5K(3) PISH SHOP CHIPS MCCAIN,3264,2448,27,561
photo-45.jpg,2,1455,1483,1395,1995,2K{6) HASH SHOWN TRIANGLE KDGKLL,3264,2448,28,600
photo-45.jpg,2,1494,1524,1340,1995,*108(12) 10* TORTILLA FLOUR C/SBLBC,3264,2448,30,655
photo-45.jpg,2,1538,1563,1452,1996,100 JAM DONUTS PAR CKO KAYMAX,3264,2448,25,544
photo-45.jpg,2,1575,1602,1320,1995,♦#110GX24 CRUNCHY CRUMB PISH C/CATCH,3264,2448,27,675
photo-45.jpg,2,1616,1645,1318,1996,*#1K{6) SWEET CHTTJ.T CHKN TENDERS ST,3264,2448,29,678
photo-45.jpg,2,1658,1683,1413,1995,*200MLX24 APPLE JCB TETRA PRXNA,3264,2448,25,582
photo-45.jpg,2,1698,1724,1394,1996,*200MLX24 ORANGE JCB TETRA FRIMA,3264,2448,26,602
photo-45.jpg,2,1738,1764,1356,1996,•200MLX24 TROPICAL JCE TETRA PRIMA,3264,2448,26,640
photo-45.jpg,3,1325,1350,503,581,7.0$,3264,2448,25,78
photo-45.jpg,1,1366,1392,503,599,32.42,3264,2448,26,96
photo-45.jpg,1,1405,1432,502,579,0.00,3264,2448,27,77
photo-45.jpg,1,1446,1472,502,579,0.00,3264,2448,26,77
photo-45.jpg,1,1486,1512,501,579,0.00,3264,2448,26,78
photo-45.jpg,1,1527,1554,501,579,4.25,3264,2448,27,78
photo-45.jpg,1,1569,1594,500,577,0.00,3264,2448,25,77
photo-45.jpg,1,1609,1634,499,577,0.00,3264,2448,25,78
photo-45.jpg,1,1649,1675,498,576,4.90,3264,2448,26,78
photo-45.jpg,1,1324,1348,307,406,77.55,3264,2448,24,99
photo-45.jpg,1,1364,1388,306,421,130.57,3264,2448,24,115
photo-45.jpg,1,1404,1429,304,404,29.91,3264,2448,25,100
photo-45.jpg,1,1444,1469,305,403,43.00,3264,2448,25,98
photo-45.jpg,1,1484,1509,305,401,45.03,3264,2448,25,96
photo-45.jpg,1,1525,1550,304,401,40.77,3264,2448,25,97
photo-45.jpg,1,1563,1591,303,420,110.22,3264,2448,28,117
photo-45.jpg,1,1607,1632,302,420,232.19,3264,2448,25,118
photo-45.jpg,1,1648,1672,301,400,75.00,3264,2448,24,99
photo-45.jpg,3,1689,1712,302,415,126-46,3264,2448,23,113
photo-45.jpg,1,1729,1753,300,415,120.40,3264,2448,24,115
photo-45.jpg,1,1328,1352,636,732,35.25,3264,2448,24,96
photo-45.jpg,1,1368,1393,635,732,17.74,3264,2448,25,97
photo-45.jpg,3,1408,1433,635,711,9-97,3264,2448,25,76
photo-45.jpg,3,1448,1489,624,713,7.10 j,3264,2448,41,89
photo-45.jpg,1,1488,1514,633,711,3.75,3264,2448,26,78
photo-45.jpg,1,1530,1555,634,729,42.52,3264,2448,25,95
photo-45.jpg,1,1335,1360,2065,2178,017568,3264,2448,25,113
photo-45.jpg,1,1376,1400,2065,2178,035986,3264,2448,24,113
photo-45.jpg,1,1418,1439,2065,2177,052278,3264,2448,21,112
photo-45.jpg,1,1458,1481,2065,2178,058420,3264,2448,23,113
photo-45.jpg,1,1498,1521,2066,2178,058766,3264,2448,23,112
photo-45.jpg,1,1540,1563,2067,2179,080343,3264,2448,23,112
photo-45.jpg,1,1580,1603,2066,2178,085591,3264,2448,23,112
photo-45.jpg,1,1619,1644,2066,2179,086645,3264,2448,25,113
photo-45.jpg,1,1660,1684,2067,2178,025889,3264,2448,24,111
photo-45.jpg,1,1701,1726,2067,2178,025890,3264,2448,25,111
photo-45.jpg,1,1741,1766,2069,2180,025891,3264,2448,25,111
photo-45.jpg,3,1340,1361,1177,1215,BA,3264,2448,21,38
photo-45.jpg,1,1335,1361,994,1075,2.001,3264,2448,26,81
photo-45.jpg,1,1331,1358,806,893,2.001,3264,2448,27,87
photo-45.jpg,1,1378,1400,1040,1076,7.,3264,2448,22,36
photo-45.jpg,1,1375,1398,816,891,7.00,3264,2448,23,75
photo-45.jpg,1,1415,1438,815,891,3.00,3264,2448,23,76
photo-45.jpg,1,1455,1479,814,891,6.00,3264,2448,24,77
photo-45.jpg,3,1380,1401,1177,1216,EA,3264,2448,21,39
photo-45.jpg,1,1416,1440,1003,1075,3.00,3264,2448,24,72
photo-45.jpg,1,1457,1480,1001,1073,6.00,3264,2448,23,72
photo-45.jpg,1,1496,1521,1002,1092,12.00,3264,2448,25,90
photo-45.jpg,3,1420,1442,1176,1217,3A,3264,2448,22,41
photo-45.jpg,3,1460,1481,1174,1216,SA,3264,2448,21,42
photo-45.jpg,1,1495,1519,814,909,12.00,3264,2448,24,95
photo-45.jpg,1,1537,1560,813,891,1.00,3264,2448,23,78
photo-45.jpg,3,1501,1521,1176,1216,BA,3264,2448,20,40
photo-45.jpg,3,1542,1562,1175,1216,EA,3264,2448,20,41
photo-45.jpg,1,1538,1562,1001,1074,1.00,3264,2448,24,73
photo-45.jpg,1,1580,1603,1001,1074,4.00,3264,2448,23,73
photo-45.jpg,1,1570,1595,633,730,27.55,3264,2448,25,97
photo-45.jpg,1,1611,1636,631,729,12.90,3264,2448,25,98
photo-45.jpg,1,1651,1676,630,728,11.50,3264,2448,25,98
photo-45.jpg,3,1682,1735,499,727,11.50| 11.50,3264,2448,53,228
photo-45.jpg,3,1715,1766,497,726,11.50| 11.50,3264,2448,51,229
photo-45.jpg,3,1582,1603,1174,1214,EA,3264,2448,21,40
photo-45.jpg,1,1577,1601,813,890,4.00,3264,2448,24,77
photo-45.jpg,3,1623,1643,1173,1215,BA,3264,2448,20,42
photo-45.jpg,1,1619,1644,1000,1092,18.00,3264,2448,25,92
photo-45.jpg,1,1660,1684,999,1090,10.00,3264,2448,24,91
photo-45.jpg,1,1701,1725,999,1090,10.00,3264,2448,24,91
photo-45.jpg,1,1740,1764,998,1089,10.00,3264,2448,24,91
photo-45.jpg,1,1618,1641,812,907,10.00,3264,2448,23,95
photo-45.jpg,3,1663,1684,1174,1213,EA,3264,2448,21,39
photo-45.jpg,1,1658,1681,812,887,6.00,3264,2448,23,75
photo-45.jpg,1,1699,1724,810,906,10.00,3264,2448,25,96
photo-45.jpg,1,1739,1763,811,905,10.00,3264,2448,24,94
photo-45.jpg,3,1705,1724,1173,1212,EA,3264,2448,19,39
photo-45.jpg,3,1745,1765,1173,1212,EA,3264,2448,20,39
photo-46.jpg,2,1319,1344,1687,2050,*#2K(6) PEAS EDGELL,3264,2448,25,363
photo-46.jpg,2,1357,1385,1423,2051,* #1.5K { 4) PARMESAN GRATED PERFECT,3264,2448,28,628
photo-46.jpg,2,1397,1426,1387,2051,*2K(3) TASTY SHREDDED CHEESE D/HAL2,3264,2448,29,664
photo-46.jpg,2,1438,1464,1478,2050,"*2.21, PREMIUM SOUR CREAM BULLA",3264,2448,26,572
photo-46.jpg,2,1479,1508,1367,2050,*P/C 4.86X90(6) VBGEMITE 1SERV KRAFT,3264,2448,29,683
photo-46.jpg,2,1520,1549,1364,2050,*500(6) 1PLY WHT LUNCH SEKVlktlTK STL,3264,2448,29,686
photo-46.jpg,2,1561,1589,1441,2049,*#P/C 50(6) STRAWBERRY JAM ZOCSH,3264,2448,28,608
photo-46.jpg,2,1601,1629,1364,2050,10K STICKY DATE PUDDING MIX ALLIED/M,3264,2448,28,686
photo-46.jpg,2,1645,1672,1554,2049,*#P/C 50(6) PLUM JAM ZOOSH,3264,2448,27,495
photo-46.jpg,1,1306,1329,344,438,24.44,3264,2448,23,94
photo-46.jpg,1,1308,1331,541,616,0.00,3264,2448,23,75
photo-46.jpg,1,1320,1342,2126,2240,012079,3264,2448,22,114
photo-46.jpg,1,1360,1384,2125,2240,080290,3264,2448,24,115
photo-46.jpg,1,1402,1425,2125,2240,085528,3264,2448,23,115
photo-46.jpg,1,1443,1466,2126,2240,088307,3264,2448,23,114
photo-46.jpg,1,1484,1508,2126,2239,027985,3264,2448,24,113
photo-46.jpg,1,1526,1550,2124,2240,050915,3264,2448,24,116
photo-46.jpg,1,1567,1590,2125,2238,072821,3264,2448,23,113
photo-46.jpg,1,1608,1632,2125,2239,081441,3264,2448,24,114
photo-46.jpg,1,1651,1674,2125,2238,088516,3264,2448,23,113
photo-46.jpg,1,1309,1333,675,751,6.11,3264,2448,24,76
photo-46.jpg,1,1349,1374,676,769,32.32,3264,2448,25,93
photo-46.jpg,1,1390,1413,675,768,16.28,3264,2448,23,93
photo-46.jpg,3,1320,1341,1220,1260,HA,3264,2448,21,40
photo-46.jpg,1,1317,1339,1034,1117,4.001,3264,2448,22,83
photo-46.jpg,1,1315,1338,856,931,4.00,3264,2448,23,75
photo-46.jpg,1,1345,1370,344,438,32.32,3264,2448,25,94
photo-46.jpg,1,1348,1372,541,617,0.00,3264,2448,24,76
photo-46.jpg,1,1390,1413,542,616,0.00,3264,2448,23,74
photo-46.jpg,1,1430,1454,542,616,0.00,3264,2448,24,74
photo-46.jpg,1,1355,1380,1042,1116,1.00,3264,2448,25,74
photo-46.jpg,1,1399,1420,1043,1116,2.00,3264,2448,21,73
photo-46.jpg,3,1361,1381,1220,1259,EA,3264,2448,20,39
photo-46.jpg,1,1356,1379,856,930,1.00,3264,2448,23,74
photo-46.jpg,1,1387,1410,345,437,32.56,3264,2448,23,92
photo-46.jpg,1,1428,1452,344,436,17.86,3264,2448,24,92
photo-46.jpg,1,1394,1420,846,931,2.001,3264,2448,26,85
photo-46.jpg,3,1402,1421,1221,1259,BA,3264,2448,19,38
photo-46.jpg,1,1429,1455,675,768,17.86,3264,2448,26,93
photo-46.jpg,3,1442,1463,1220,1258,EA,3264,2448,21,38
photo-46.jpg,1,1440,1462,1042,1115,1.00,3264,2448,22,73
photo-46.jpg,3,1431,1461,845,929,l-OOl,3264,2448,30,84
photo-46.jpg,3,1480,1518,844,928,2 - OS j,3264,2448,38,84
photo-46.jpg,1,1520,1542,853,928,6.30,3264,2448,22,75
photo-46.jpg,1,1469,1492,344,437,25.63,3264,2448,23,93
photo-46.jpg,1,1471,1495,540,615,0.00,3264,2448,24,75
photo-46.jpg,1,1512,1536,539,616,2.35,3264,2448,24,77
photo-46.jpg,1,1553,1576,538,613,0.00,3264,2448,23,75
photo-46.jpg,1,1593,1617,538,612,0.00,3264,2448,24,74
photo-46.jpg,1,1636,1659,536,612,0.00,3264,2448,23,76
photo-46.jpg,1,1471,1495,675,767,12.82,3264,2448,24,92
photo-46.jpg,1,1512,1536,673,748,3.92,3264,2448,24,75
photo-46.jpg,1,1553,1576,673,748,4.91,3264,2448,23,75
photo-46.jpg,1,1594,1618,673,764,35.62,3264,2448,24,91
photo-46.jpg,1,1635,1658,673,746,4.44,3264,2448,23,73
photo-46.jpg,1,1473,1502,1033,1116,2.001,3264,2448,29,83
photo-46.jpg,1,1521,1544,1031,1114,6.001,3264,2448,23,83
photo-46.jpg,3,1562,1584,1032,1113,3 -SO!,3264,2448,22,81
photo-46.jpg,3,1483,1503,1220,1258,BA,3264,2448,20,38
photo-46.jpg,1,1510,1533,342,436,25.87,3264,2448,23,94
photo-46.jpg,1,1550,1574,341,415,0.00,3264,2448,24,74
photo-46.jpg,1,1591,1615,340,433,35.62,3264,2448,24,93
photo-46.jpg,3,1632,1658,334,433,13.32],3264,2448,26,99
photo-46.jpg,3,1525,1546,1218,1258,EA,3264,2448,21,40
photo-46.jpg,3,1565,1586,1218,1256,BA,3264,2448,21,38
photo-46.jpg,3,1562,1583,843,1022,HOT AVAILi,3264,2448,21,179
photo-46.jpg,3,1603,1626,1032,1112,l.OOl,3264,2448,23,80
photo-46.jpg,1,1601,1624,852,926,1.00,3264,2448,23,74
photo-46.jpg,3,1607,1626,1219,1256,EA,3264,2448,19,37
photo-46.jpg,3,1648,1668,1218,1256,EA,3264,2448,20,38
photo-46.jpg,1,1638,1668,1031,1113,3.001,3264,2448,30,82
photo-46.jpg,3,1643,1666,848,927,3.oa,3264,2448,23,79
photo-47.jpg,2,1101,1140,1561,1988,2.5kg STARPAK BROCCOLI,3264,2448,39,427
photo-47.jpg,2,1149,1187,1521,1987,1 kg STARPAK CAULIFLOWER,3264,2448,38,466
photo-47.jpg,2,1195,1235,1499,1986,1 kg STARPAK CORN KERNELS,3264,2448,40,487
photo-47.jpg,2,1244,1284,1544,1988,2kg STARPAK GREEN PEAS,3264,2448,40,444
photo-47.jpg,2,1289,1332,1392,1984,1.5kg EDGELLS MELANGE VEGIE MIX,3264,2448,43,592
photo-47.jpg,2,1339,1375,1482,1983,10lt BULLA VANILLA ICE CREAM,3264,2448,36,501
photo-47.jpg,2,1380,1428,1198,1984,150x32gm ARN CREMY CHC/SHORT CREAM BISC,3264,2448,48,786
photo-47.jpg,2,1437,1471,1579,1986,A9 SH DICED TOMATOES,3264,2448,34,407
photo-47.jpg,2,1483,1526,1505,2183,PASPENSAN 10kg SR PENNE PASTA(No.18),3264,2448,43,678
photo-47.jpg,3,1111,1136,2029,2186,BROCS2.5,3264,2448,25,157
photo-47.jpg,3,1160,1185,2058,2187,CAULIS1,3264,2448,25,129
photo-47.jpg,3,1208,1233,2031,2187,CORKERS,3264,2448,25,156
photo-47.jpg,3,1256,1281,2082,2186,PEASS,3264,2448,25,104
photo-47.jpg,3,1305,1329,2057,2185,MELVEG,3264,2448,24,128
photo-47.jpg,3,1353,1378,2033,2184,ICREAM11,3264,2448,25,151
photo-47.jpg,1,1090,1117,997,1077,4.000,3264,2448,27,80
photo-47.jpg,1,1138,1165,996,1093,10.000,3264,2448,27,97
photo-47.jpg,1,1185,1213,994,1094,20.000,3264,2448,28,100
photo-47.jpg,3,1234,1268,993,1081,.5.000,3264,2448,34,88
photo-47.jpg,1,1282,1308,991,1090,12.000,3264,2448,26,99
photo-47.jpg,1,1330,1356,990,1072,4.000,3264,2448,26,82
photo-47.jpg,1,1378,1404,989,1071,2.000,3264,2448,26,82
photo-47.jpg,1,1425,1453,987,1070,6.000,3264,2448,28,83
photo-47.jpg,1,1473,1501,986,1068,0.500,3264,2448,28,82
photo-47.jpg,1,1087,1114,853,913,8.00,3264,2448,27,60
photo-47.jpg,1,1086,1111,681,742,0.00,3264,2448,25,61
photo-47.jpg,1,1075,1103,369,450,32.00,3264,2448,28,81
photo-47.jpg,1,1123,1151,369,450,21.50,3264,2448,28,81
photo-47.jpg,1,1171,1199,366,449,64.00,3264,2448,28,83
photo-47.jpg,1,1219,1247,364,448,27.00,3264,2448,28,84
photo-47.jpg,1,1267,1294,363,446,84.00,3264,2448,27,83
photo-47.jpg,1,1316,1342,361,443,85.36,3264,2448,26,82
photo-47.jpg,1,1363,1390,361,443,81.84,3264,2448,27,82
photo-47.jpg,1,1411,1438,359,441,31.80,3264,2448,27,82
photo-47.jpg,1,1083,1108,536,598,0.00,3264,2448,25,62
photo-47.jpg,1,1134,1161,851,915,2.15,3264,2448,27,64
photo-47.jpg,1,1133,1158,681,742,0.00,3264,2448,25,61
photo-47.jpg,1,1131,1156,536,597,0.00,3264,2448,25,61
photo-47.jpg,1,1182,1210,850,912,3.20,3264,2448,28,62
photo-47.jpg,1,1181,1206,678,740,0.00,3264,2448,25,62
photo-47.jpg,1,1179,1204,533,596,0.00,3264,2448,25,63
photo-47.jpg,3,1402,1427,2023,2185,BISCREPC,3264,2448,25,162
photo-47.jpg,3,1450,1475,2038,2186,TOMDICS,3264,2448,25,148
photo-47.jpg,1,1230,1257,849,911,5.40,3264,2448,27,62
photo-47.jpg,1,1229,1254,677,739,0.00,3264,2448,25,62
photo-47.jpg,1,1227,1252,532,595,0.00,3264,2448,25,63
photo-47.jpg,1,1278,1305,846,911,7.00,3264,2448,27,65
photo-47.jpg,1,1278,1302,676,738,0.00,3264,2448,24,62
photo-47.jpg,1,1275,1299,531,593,0.00,3264,2448,24,62
photo-47.jpg,1,1325,1353,845,924,19.40,3264,2448,28,79
photo-47.jpg,1,1374,1400,845,925,37.20,3264,2448,26,80
photo-47.jpg,1,1325,1350,673,735,0.00,3264,2448,25,62
photo-47.jpg,1,1322,1348,528,591,7.76,3264,2448,26,63
photo-47.jpg,1,1374,1398,674,735,0.00,3264,2448,24,61
photo-47.jpg,1,1371,1395,529,589,7.44,3264,2448,24,60
photo-47.jpg,3,1422,1448,843,905,S.30,3264,2448,26,62
photo-47.jpg,1,1422,1446,671,733,0.00,3264,2448,24,62
photo-47.jpg,1,1418,1444,526,588,0.00,3264,2448,26,62
photo-47.jpg,1,1470,1496,841,921,17.50,3264,2448,26,80
photo-47.jpg,3,1453,1486,355,431,'8.75,3264,2448,33,76
photo-47.jpg,1,1469,1494,669,731,0.00,3264,2448,25,62
photo-47.jpg,1,1467,1492,524,587,0.00,3264,2448,25,63
photo-48.jpg,2,1082,1119,1409,2160,"FOTFRCSHG 1 ,:ko GC FRESH FILLET OF THIGH",3264,2448,37,751
photo-48.jpg,1,1057,1087,307,391,96.00,3264,2448,30,84
photo-48.jpg,1,1073,1100,947,1028,1.000,3264,2448,27,81
photo-48.jpg,1,1070,1098,800,883,96.00,3264,2448,28,83
photo-48.jpg,1,1070,1095,627,688,0.00,3264,2448,25,61
photo-48.jpg,1,1065,1092,479,541,0.00,3264,2448,27,62
photo-49.jpg,2,1158,1194,1483,2064,30V6Qgm IMG THIGH SCHNITZELS,3264,2448,36,581
photo-49.jpg,2,1210,1244,1600,2064,2.5kg KR RINDLESS BACON,3264,2448,34,464
photo-49.jpg,2,1261,1296,1554,2063,5x38gm LEDA GF APPLE BARS,3264,2448,35,509
photo-49.jpg,2,1311,1347,1421,2063,5x33gm LEDA GF STRAWBERRY BARS,3264,2448,36,642
photo-49.jpg,2,1361,1397,1414,2065,SXSSgm LEDA GF TRIPLE BERRY BARS,3264,2448,36,651
photo-49.jpg,2,1412,1441,1399,2064,FREEDOM GF/NUT FREE MUESLI BARS,3264,2448,29,665
photo-49.jpg,2,1461,1493,1649,2066,2.4ft BERRi APPLE JUICE,3264,2448,32,417
photo-49.jpg,2,1513,1544,1609,2067,2.4ft BERRI ORANGE JUICE,3264,2448,31,458
photo-49.jpg,2,1563,1601,1619,2066,2.95X9 hnz baked beans,3264,2448,38,447
photo-49.jpg,2,1615,1653,1671,2067,2.95kg HNZ SPAGHETTI,3264,2448,38,396
photo-49.jpg,2,1667,1705,1627,2065,3kg HEINZ PEACH SLICES,3264,2448,38,438
photo-49.jpg,2,1718,1757,1652,2065,3kg HEINZ PEAR SLICES,3264,2448,39,413
photo-49.jpg,2,1768,1806,1529,2277,COTOttS-l* 2QKSOLERO COTTONSEED-OIL,3264,2448,38,748
photo-49.jpg,3,1160,1190,2112,2273,CSCHI ISO,3264,2448,30,161
photo-49.jpg,3,1212,1240,2138,2272,8ACEVE,3264,2448,28,134
photo-49.jpg,3,1261,1290,2124,2272,"SAR19CA,",3264,2448,29,148
photo-49.jpg,3,1314,1340,2126,2272,jwises,3264,2448,26,146
photo-49.jpg,3,1365,1391,2126,2273,SAR190T,3264,2448,26,147
photo-49.jpg,3,1416,1442,2110,2274,ML-6SARN,3264,2448,26,164
photo-49.jpg,3,1467,1496,2144,2278,FA4SA,3264,2448,29,134
photo-49.jpg,3,1518,1546,2142,2278,FJ3.4SO,3264,2448,28,136
photo-49.jpg,3,1570,1598,2117,2277,BEABAKH,3264,2448,28,160
photo-49.jpg,3,1622,1651,2161,2278,SPAGH,3264,2448,29,117
photo-49.jpg,3,1674,1703,2136,2277,P€ASUK,3264,2448,29,141
photo-49.jpg,3,1726,1753,2120,2277,PEARSLN,3264,2448,27,157
photo-49.jpg,1,1159,1187,1024,1110,5.000,3264,2448,28,86
photo-49.jpg,1,1160,1187,872,958,47.50,3264,2448,27,86
photo-49.jpg,1,1210,1237,1024,1109,6.000,3264,2448,27,85
photo-49.jpg,1,1210,1237,872,956,23.20,3264,2448,27,84
photo-49.jpg,1,1260,1287,1024,1109,6.000,3264,2448,27,85
photo-49.jpg,1,1260,1287,871,937,4.00,3264,2448,27,66
photo-49.jpg,1,1310,1337,1024,1109,6.000,3264,2448,27,85
photo-49.jpg,1,1310,1337,871,936,4.00,3264,2448,27,65
photo-49.jpg,1,1360,1388,1022,1109,6.000,3264,2448,28,87
photo-49.jpg,1,1360,1387,870,936,4.00,3264,2448,27,66
photo-49.jpg,1,1410,1438,1021,1109,6.000,3264,2448,28,88
photo-49.jpg,1,1410,1437,869,935,5.60,3264,2448,27,66
photo-49.jpg,1,1460,1489,1022,1126,12.000,3264,2448,29,104
photo-49.jpg,1,1461,1487,870,936,4.50,3264,2448,26,66
photo-49.jpg,1,1511,1539,1023,1127,24.000,3264,2448,28,104
photo-49.jpg,1,1511,1538,870,936,4.50,3264,2448,27,66
photo-49.jpg,1,1562,1590,1021,1107,6.000,3264,2448,28,86
photo-49.jpg,3,1562,1589,838,932,8.90 .,3264,2448,27,94
photo-49.jpg,1,1612,1641,1020,1106,6.000,3264,2448,29,86
photo-49.jpg,1,1613,1641,868,932,8.90,3264,2448,28,64
photo-49.jpg,1,1664,1692,1020,1105,3.000,3264,2448,28,85
photo-49.jpg,1,1664,1691,867,950,10.30,3264,2448,27,83
photo-49.jpg,3,1715,1744,832,1137,.-3.000.— 1-1-30—,3264,2448,29,305
photo-49.jpg,1,1765,1793,1019,1104,1.000,3264,2448,28,85
photo-49.jpg,1,1765,1792,866,949,50.00,3264,2448,27,83
photo-49.jpg,1,1157,1184,371,476,237.50,3264,2448,27,105
photo-49.jpg,1,1207,1235,370,472,139.20,3264,2448,28,102
photo-49.jpg,1,1257,1284,370,455,26.40,3264,2448,27,85
photo-49.jpg,1,1307,1334,370,454,26.40,3264,2448,27,84
photo-49.jpg,3,1358,1385,357,454,26.40-,3264,2448,27,97
photo-49.jpg,1,1408,1435,367,452,36.96,3264,2448,27,85
photo-49.jpg,1,1457,1485,368,452,54.00,3264,2448,28,84
photo-49.jpg,1,1508,1536,368,470,108.00,3264,2448,28,102
photo-49.jpg,1,1558,1585,366,450,53.40,3264,2448,27,84
photo-49.jpg,1,1609,1637,364,448,53.40,3264,2448,28,84
photo-49.jpg,1,1660,1687,363,448,30.90,3264,2448,27,85
photo-49.jpg,1,1710,1738,362,449,33.90,3264,2448,28,87
photo-49.jpg,3,1757,1789,362,469,! 50.00,3264,2448,32,107
photo-49.jpg,1,1161,1186,696,757,0.00,3264,2448,25,61
photo-49.jpg,1,1161,1186,547,609,0.00,3264,2448,25,62
photo-49.jpg,1,1212,1235,695,755,0.00,3264,2448,23,60
photo-49.jpg,1,1212,1236,545,607,0.00,3264,2448,24,62
photo-49.jpg,1,1262,1286,693,756,0.00,3264,2448,24,63
photo-49.jpg,1,1262,1286,546,606,2.40,3264,2448,24,60
photo-49.jpg,1,1312,1336,694,756,0.00,3264,2448,24,62
photo-49.jpg,1,1312,1336,545,607,2.40,3264,2448,24,62
photo-49.jpg,1,1362,1386,692,755,0.00,3264,2448,24,63
photo-49.jpg,1,1363,1387,543,606,2.40,3264,2448,24,63
photo-49.jpg,1,1413,1436,692,754,0.00,3264,2448,23,62
photo-49.jpg,1,1412,1437,543,605,3.36,3264,2448,25,62
photo-49.jpg,1,1462,1486,692,754,0.00,3264,2448,24,62
photo-49.jpg,1,1462,1487,544,605,0.00,3264,2448,25,61
photo-49.jpg,1,1512,1538,692,754,0.00,3264,2448,26,62
photo-49.jpg,1,1512,1537,544,604,0.00,3264,2448,25,60
photo-49.jpg,1,1564,1588,690,753,0.00,3264,2448,24,63
photo-49.jpg,1,1563,1588,541,603,0.00,3264,2448,25,62
photo-49.jpg,1,1614,1639,690,752,0.00,3264,2448,25,62
photo-49.jpg,1,1613,1639,540,602,0.00,3264,2448,26,62
photo-49.jpg,1,1664,1690,539,602,0.00,3264,2448,26,63
photo-49.jpg,1,1666,1690,690,751,0.00,3264,2448,24,61
photo-49.jpg,3,1714,1747,506,751,0*00 {jj ^oulQ.QQco-,3264,2448,33,245
photo-49.jpg,3,1765,1795,686,750,o.q°,3264,2448,30,64
photo-49.jpg,1,1765,1789,537,599,0.00,3264,2448,24,62
photo-50.jpg,2,1140,1184,1596,2254,CHITHIGC12 12kg GC FRESH Bl THIGHS,3264,2448,44,658
photo-50.jpg,1,1121,1147,540,604,0.00,3264,2448,26,64
photo-50.jpg,1,1113,1142,368,470,169.25,3264,2448,29,102
photo-50.jpg,1,1130,1159,1017,1101,5.000,3264,2448,29,84
photo-50.jpg,1,1127,1155,868,951,33.85,3264,2448,28,83
photo-50.jpg,1,1125,1150,691,753,0.00,3264,2448,25,62
photo-51.jpg,2,1103,1137,1596,2055,10kg FOWVNA JASMNE RICE,3264,2448,34,459
photo-51.jpg,2,1152,1186,1609,2056,2.5kg KR RWDLESS BACON,3264,2448,34,447
photo-51.jpg,2,1199,1228,1516,2054,100s EDGELLS CORN COBETTES,3264,2448,29,538
photo-51.jpg,3,1141,1169,424,527,isaasB,3264,2448,28,103
photo-51.jpg,1,1190,1217,425,510,47.33,3264,2448,27,85
photo-51.jpg,3,1108,1131,2122,2260,RICJASR,3264,2448,23,138
photo-51.jpg,3,1156,1180,2130,2261,BACEVE,3264,2448,24,131
photo-51.jpg,3,1203,1230,2116,2263,CORCOB,3264,2448,27,147
photo-51.jpg,3,1147,1188,907,992,pj2S,3264,2448,41,85
photo-51.jpg,3,1196,1221,909,992,cs:,3264,2448,25,83
photo-51.jpg,1,1101,1126,1054,1140,2.300,3264,2448,25,86
photo-51.jpg,3,1097,1122,594,655,ax,3264,2448,25,61
photo-51.jpg,3,1101,1124,738,801,ax,3264,2448,23,63
photo-51.jpg,3,1149,1173,1056,1134,5 XX,3264,2448,24,78
photo-51.jpg,3,1145,1169,593,653,ax,3264,2448,24,60
photo-51.jpg,3,1148,1171,736,798,ax,3264,2448,23,62
photo-51.jpg,3,1193,1217,592,655,ax,3264,2448,24,63
photo-51.jpg,3,1196,1221,1054,1136,t.OOC,3264,2448,25,82
photo-51.jpg,3,1196,1220,737,798,ax,3264,2448,24,61
photo-52.jpg,2,1097,1141,1526,2015,tSg S~XRPV< CORN KERNELS,3264,2448,44,489
photo-52.jpg,2,1146,1188,1569,2018,Sfcg BDGELLS GREEN =EAS,3264,2448,42,449
photo-52.jpg,2,1192,1238,1449,2012,SS§ FNDUS IESXEYVEGE!A3LES,3264,2448,46,563
photo-52.jpg,2,1239,1284,1375,2218,COPFSSSM'XSJX* 7gtr. NESCAFE 5*3 PC COF^K,3264,2448,45,843
photo-52.jpg,2,1292,1328,1494,2011,‘3s BELLA SPliT\ARE~Y f*ACK,3264,2448,36,517
photo-52.jpg,2,1339,1381,1447,2011,152*35gr: AC W«TE DINNER ROLL,3264,2448,42,564
photo-52.jpg,2,1390,1430,1568,2014,25V5 NR RKDLESS BACON,3264,2448,40,446
photo-52.jpg,2,1483,1530,1374,2013,5&S NESTLE CALYPSO DARK 3UTT0NS,3264,2448,47,639
photo-52.jpg,2,1532,1577,1415,2013,osag EDGSLLS SLICE) beetroot,3264,2448,45,598
photo-52.jpg,2,1580,1622,1356,2011,IS* CAU6RE 3L5NDe> VEGETABLE Gi.,3264,2448,42,655
photo-52.jpg,3,1208,1236,2079,2220,MB2NES,3264,2448,28,141
photo-52.jpg,3,1110,1136,2060,2220,CORNERS,3264,2448,26,160
photo-52.jpg,1,1085,1114,1016,1115,10.000,3264,2448,29,99
photo-52.jpg,3,1078,1113,869,980,c^TTxS,3264,2448,35,111
photo-52.jpg,3,1115,1170,868,1098,6 000-^5.40,3264,2448,55,230
photo-52.jpg,3,1182,1211,1006,1113,12-ootr,3264,2448,29,107
photo-52.jpg,3,1231,1259,1012,1095,1J000,3264,2448,28,83
photo-52.jpg,1,1280,1308,1011,1110,10.000,3264,2448,28,99
photo-52.jpg,3,1328,1356,1008,1094,IjOOO,3264,2448,28,86
photo-52.jpg,3,1377,1404,1008,1093,4jOOO,3264,2448,27,85
photo-52.jpg,3,1425,1454,1006,1090,1D00,3264,2448,29,84
photo-52.jpg,3,1466,1502,857,1089,3JJ00 ^39.50,3264,2448,36,232
photo-52.jpg,3,1518,1551,857,1087,2.000 ^^7.90,3264,2448,33,230
photo-52.jpg,3,1572,1600,981,1086,2.000 ”,3264,2448,28,105
photo-52.jpg,3,1565,1595,855,949,37.00,3264,2448,30,94
photo-52.jpg,3,1610,1650,853,1084,idoo—faeo,3264,2448,40,231
photo-52.jpg,1,1076,1100,548,613,0.00,3264,2448,24,65
photo-52.jpg,1,1069,1095,382,465,32.00,3264,2448,26,83
photo-52.jpg,1,1118,1145,381,464,32.40,3264,2448,27,83
photo-52.jpg,3,1173,1199,545,610,OjOO,3264,2448,26,65
photo-52.jpg,1,1166,1194,379,462,63.60,3264,2448,28,83
photo-52.jpg,1,1222,1247,544,608,0.00,3264,2448,25,64
photo-52.jpg,1,1215,1242,377,477,144.40,3264,2448,27,100
photo-52.jpg,1,1265,1291,376,458,5720,3264,2448,26,82
photo-52.jpg,1,1320,1344,541,605,0.00,3264,2448,24,64
photo-52.jpg,1,1314,1339,373,458,32.70,3264,2448,25,85
photo-52.jpg,1,1361,1388,373,456,92.80,3264,2448,27,83
photo-52.jpg,1,1417,1442,538,601,0.00,3264,2448,25,63
photo-52.jpg,1,1409,1437,371,454,23.10,3264,2448,28,83
photo-52.jpg,3,1466,1491,536,600,0:00,3264,2448,25,64
photo-52.jpg,1,1460,1486,372,469,118.50,3264,2448,26,97
photo-52.jpg,1,1516,1539,534,598,0.99,3264,2448,23,64
photo-52.jpg,1,1507,1535,368,450,15.80,3264,2448,28,82
photo-52.jpg,3,1564,1588,533,597,OjOO,3264,2448,24,64
photo-52.jpg,1,1556,1583,367,449,74.00,3264,2448,27,82
photo-52.jpg,3,1613,1652,480,630,rsdyP§o-.&,3264,2448,39,150
photo-52.jpg,1,1606,1633,364,448,77.66,3264,2448,27,84
photo-52.jpg,1,1081,1104,697,756,3.00,3264,2448,23,59
photo-52.jpg,3,1159,1185,2133,2220,PEAS,3264,2448,26,87
photo-52.jpg,3,1128,1152,695,756,COO,3264,2448,24,61
photo-52.jpg,1,1125,1149,547,610,0.00,3264,2448,24,63
photo-52.jpg,3,1177,1202,692,757,aoo,3264,2448,25,65
photo-52.jpg,3,1179,1205,866,917,e30,3264,2448,26,51
photo-52.jpg,1,1227,1255,864,966,142.40,3264,2448,28,102
photo-52.jpg,3,1225,1251,691,755,aoo,3264,2448,26,64
photo-52.jpg,3,1502,1529,2056,2214,CHCOARS,3264,2448,27,158
photo-52.jpg,1,1277,1303,863,928,520,3264,2448,26,65
photo-52.jpg,3,1275,1299,690,753,aoo,3264,2448,24,63
photo-52.jpg,1,1272,1296,543,605,520,3264,2448,24,62
photo-52.jpg,3,1356,1381,2161,2218,K5S,3264,2448,25,57
photo-52.jpg,3,1321,1375,860,1001,—^70,3264,2448,54,141
photo-52.jpg,3,1370,1401,860,991,-^2320,3264,2448,31,131
photo-52.jpg,3,1323,1347,688,752,aoo,3264,2448,24,64
photo-52.jpg,3,1404,1430,2086,2215,3ACSVE,3264,2448,26,129
photo-52.jpg,3,1371,1396,687,751,aoo,3264,2448,25,64
photo-52.jpg,1,1368,1394,540,604,0.00,3264,2448,26,64
photo-52.jpg,1,1422,1450,860,951,23.10,3264,2448,28,91
photo-52.jpg,3,1420,1446,686,749,aoo,3264,2448,26,63
photo-52.jpg,3,1469,1494,684,747,aoo,3264,2448,25,63
photo-52.jpg,1,1518,1543,682,746,0.00,3264,2448,25,64
photo-52.jpg,3,1599,1628,2069,2216,VEGCO.C,3264,2448,29,147
photo-52.jpg,3,1567,1591,680,744,aoo,3264,2448,24,64
photo-52.jpg,1,1617,1641,678,742,0.00,3264,2448,24,64
photo-53.jpg,2,1091,1126,1553,1953,1.5kg EDGELLS BROCCOLI,3264,2448,35,400
photo-53.jpg,2,1136,1171,1517,1954,2kg EDGELLS CAULIFLOWER,3264,2448,35,437
photo-53.jpg,2,1182,1218,1538,1953,2kg EDGELLS GREEN PEAS,3264,2448,36,415
photo-53.jpg,2,1224,1263,1429,1951,1 kg FINDUS MEDLEY VEGETABLES,3264,2448,39,522
photo-53.jpg,2,1272,1309,1507,1952,5kg BAKELS ANZAC COOKIES,3264,2448,37,445
photo-53.jpg,2,1316,1353,1436,2141,COOCHOCHJ5kg BAKELS CHOC CHIP COOKIES,3264,2448,37,705
photo-53.jpg,2,1344,1419,1019,2208,"kg' EDCMIXSAN 12 EDC MIXED SANDWICH C^A-dUV Vo HlVlHVjV ,15.000",3264,2448,75,1189
photo-53.jpg,2,1405,1444,1428,1950,192x35gmAC WHITE DINNER ROLL,3264,2448,39,522
photo-53.jpg,2,1453,1490,1538,1952,2.5kg KR RINDLESS BACON,3264,2448,37,414
photo-53.jpg,2,1494,1536,1372,2140,COO250CC 250gm LEDA G/F CHOC CHIP COOKIES,3264,2448,42,768
photo-53.jpg,2,1544,1576,1584,1951,2lt GC PET APPLE JUICE,3264,2448,32,367
photo-53.jpg,2,1589,1622,1499,1951,2(t GC PET BREAKFAST JUICE,3264,2448,33,452
photo-53.jpg,2,1634,1669,1545,1951,2lt GC PET ORANGE JUICE,3264,2448,35,406
photo-53.jpg,2,1681,1715,1527,1952,2lt GC PET TROPICAL JUICE,3264,2448,34,425
photo-53.jpg,2,1721,1765,1210,1950,150x32gm ARN CREMY CHC/SHORT CREAM BISC,3264,2448,44,740
photo-53.jpg,2,1771,1813,1422,2141,CORFLA500 500gm SANITARIUM CORN FLAKES,3264,2448,42,719
photo-53.jpg,2,1818,1858,1503,1949,1.12kg SANITARIUM WEETBIX,3264,2448,40,446
photo-53.jpg,2,1862,1899,1343,1971,' 20lt CALIBRE BLENDED VEGETABLE OIL,3264,2448,37,628
photo-53.jpg,2,1908,1946,1337,1950,600mx45cm CACLINGWRAP DISPENSER,3264,2448,38,613
photo-53.jpg,2,1957,1993,1479,1950,50 9 PLASTIC DINNER PLATES,3264,2448,36,471
photo-53.jpg,3,1145,1169,2038,2142,CAULI2,3264,2448,24,104
photo-53.jpg,3,1237,1260,2014,2140,MEDVEG,3264,2448,23,126
photo-53.jpg,3,1281,1305,1995,2141,COOANZ5,3264,2448,24,146
photo-53.jpg,3,1465,1488,2019,2139,BACEVE,3264,2448,23,120
photo-53.jpg,3,1556,1581,2030,2139,FJ2APP,3264,2448,25,109
photo-53.jpg,3,1602,1627,2027,2139,FJ2BRE,3264,2448,25,112
photo-53.jpg,3,1648,1673,2022,2139,FJ20RA,3264,2448,25,117
photo-53.jpg,3,1739,1766,1988,2139,BISCREPC,3264,2448,27,151
photo-53.jpg,3,1832,1859,1992,2141,WEETBIX1,3264,2448,27,149
photo-53.jpg,3,1880,1906,2005,2142,VEGOILC,3264,2448,26,137
photo-53.jpg,3,1927,1952,2034,2141,CW45D,3264,2448,25,107
photo-53.jpg,3,1975,2000,2059,2141,9RND,3264,2448,25,82
photo-53.jpg,3,1100,1123,2057,2142,BROC,3264,2448,23,85
photo-53.jpg,3,1079,1111,889,1102,6.000 +^920,3264,2448,32,213
photo-53.jpg,3,1120,1153,889,1101,6.000 ~~00~7£O,3264,2448,33,212
photo-53.jpg,1,1173,1199,1023,1100,6.000,3264,2448,26,77
photo-53.jpg,3,1215,1244,885,1114,12.000-^—5.30,3264,2448,29,229
photo-53.jpg,3,1261,1289,885,1099,2.000 *—42:30,3264,2448,28,214
photo-53.jpg,3,1299,1334,884,1098,2.000 -^.90,3264,2448,35,214
photo-53.jpg,3,1345,1376,883,1022,i ——46740,3264,2448,31,139
photo-53.jpg,3,1392,1424,883,1094,1.000^^32.70,3264,2448,32,211
photo-53.jpg,1,1444,1470,1017,1095,4.000,3264,2448,26,78
photo-53.jpg,3,1474,1515,881,1094,6.000 *-T.00,3264,2448,41,213
photo-53.jpg,3,1532,1561,879,1093,6.000 --3.30,3264,2448,29,214
photo-53.jpg,3,1575,1607,877,1092,6.000 -^4.20,3264,2448,32,215
photo-53.jpg,3,1614,1653,937,1092,6.000--,3264,2448,39,155
photo-53.jpg,3,1662,1699,875,1091,6.000-<^3.90,3264,2448,37,216
photo-53.jpg,3,1705,1745,874,1087,1.000—^ViO,3264,2448,40,213
photo-53.jpg,1,1765,1791,1009,1104,12.000,3264,2448,26,95
photo-53.jpg,3,1788,1837,955,1087,4.000 ™,3264,2448,49,132
photo-53.jpg,1,1808,1833,872,930,5.40,3264,2448,25,58
photo-53.jpg,3,1847,1882,870,1084,3.000^57.00,3264,2448,35,214
photo-53.jpg,3,1883,1928,869,1083,1.000 -^2.60,3264,2448,45,214
photo-53.jpg,3,1935,1975,868,1099,10.000 ^4.80,3264,2448,40,231
photo-53.jpg,1,1077,1101,595,651,0.00,3264,2448,24,56
photo-53.jpg,1,1072,1098,438,514,55.20,3264,2448,26,76
photo-53.jpg,1,1123,1146,594,649,0.00,3264,2448,23,55
photo-53.jpg,1,1117,1143,437,514,47.40,3264,2448,26,77
photo-53.jpg,1,1162,1187,435,510,32.40,3264,2448,25,75
photo-53.jpg,1,1206,1232,434,511,63.60,3264,2448,26,77
photo-53.jpg,1,1252,1277,433,509,93.06,3264,2448,25,76
photo-53.jpg,1,1297,1323,430,508,98.78,3264,2448,26,78
photo-53.jpg,1,1352,1374,723,780,0.00,3264,2448,22,57
photo-53.jpg,1,1348,1371,587,660,69.60,3264,2448,23,73
photo-53.jpg,1,1342,1367,430,525,765.60,3264,2448,25,95
photo-53.jpg,1,1393,1417,587,643,0.00,3264,2448,24,56
photo-53.jpg,1,1387,1413,429,504,32.70,3264,2448,26,75
photo-53.jpg,1,1433,1458,428,504,92.80,3264,2448,25,76
photo-53.jpg,1,1484,1508,584,639,1.80,3264,2448,24,55
photo-53.jpg,1,1477,1503,427,501,19.80,3264,2448,26,74
photo-53.jpg,1,1523,1549,425,500,19.80,3264,2448,26,75
photo-53.jpg,1,1569,1595,424,502,25.20,3264,2448,26,78
photo-53.jpg,1,1621,1645,580,637,0.00,3264,2448,24,57
photo-53.jpg,1,1616,1641,422,498,19.80,3264,2448,25,76
photo-53.jpg,1,1662,1686,421,499,23.40,3264,2448,24,78
photo-53.jpg,1,1706,1732,419,497,40.92,3264,2448,26,78
photo-53.jpg,1,1758,1782,576,632,0.00,3264,2448,24,56
photo-53.jpg,1,1753,1779,418,495,45.60,3264,2448,26,77
photo-53.jpg,1,1804,1828,574,631,0.00,3264,2448,24,57
photo-53.jpg,1,1800,1824,417,493,21.60,3264,2448,24,76
photo-53.jpg,1,1851,1874,573,629,0.00,3264,2448,23,56
photo-53.jpg,1,1845,1871,418,507,111.00,3264,2448,26,89
photo-53.jpg,1,1897,1921,571,628,2.26,3264,2448,24,57
photo-53.jpg,1,1891,1917,411,489,24.86,3264,2448,26,78
photo-53.jpg,1,1937,1963,409,487,52.80,3264,2448,26,78
photo-53.jpg,1,1080,1104,729,785,0.00,3264,2448,24,56
photo-53.jpg,1,1126,1149,729,784,0.00,3264,2448,23,55
photo-53.jpg,3,1191,1215,2064,2141,PEAS,3264,2448,24,77
photo-53.jpg,1,1171,1196,888,945,5.40,3264,2448,25,57
photo-53.jpg,1,1171,1194,728,783,0.00,3264,2448,23,55
photo-53.jpg,1,1168,1191,592,648,0.00,3264,2448,23,56
photo-53.jpg,1,1216,1238,726,782,0.00,3264,2448,22,56
photo-53.jpg,1,1213,1236,591,648,0.00,3264,2448,23,57
photo-53.jpg,1,1262,1283,725,782,0.00,3264,2448,21,57
photo-53.jpg,1,1259,1281,589,646,8.46,3264,2448,22,57
photo-53.jpg,1,1306,1329,724,781,0.00,3264,2448,23,57
photo-53.jpg,1,1304,1326,589,645,8.98,3264,2448,22,56
photo-53.jpg,1,1421,1442,2091,2140,059,3264,2448,21,49
photo-53.jpg,1,1397,1420,722,778,0.00,3264,2448,23,56
photo-53.jpg,1,1442,1465,721,776,0.00,3264,2448,23,55
photo-53.jpg,1,1439,1462,586,641,0.00,3264,2448,23,55
photo-53.jpg,1,1488,1510,720,775,0.00,3264,2448,22,55
photo-53.jpg,1,1533,1555,719,774,0.00,3264,2448,22,55
photo-53.jpg,1,1530,1553,583,639,0.00,3264,2448,23,56
photo-53.jpg,1,1579,1601,717,773,0.00,3264,2448,22,56
photo-53.jpg,1,1575,1598,581,637,0.00,3264,2448,23,56
photo-53.jpg,1,1624,1647,716,773,0.00,3264,2448,23,57
photo-53.jpg,3,1696,1720,2070,2139,FJ2T,3264,2448,24,69
photo-53.jpg,1,1669,1694,715,771,0.00,3264,2448,25,56
photo-53.jpg,1,1668,1690,579,636,0.00,3264,2448,22,57
photo-53.jpg,1,1715,1739,713,770,0.00,3264,2448,24,57
photo-53.jpg,1,1713,1736,577,634,3.72,3264,2448,23,57
photo-53.jpg,1,1762,1788,873,931,3.80,3264,2448,26,58
photo-53.jpg,1,1762,1785,711,768,0.00,3264,2448,23,57
photo-53.jpg,1,1808,1831,711,767,0.00,3264,2448,23,56
photo-53.jpg,1,1854,1876,710,766,0.00,3264,2448,22,56
photo-53.jpg,1,1900,1923,708,764,0.00,3264,2448,23,56
photo-53.jpg,1,1946,1969,707,763,0.00,3264,2448,23,56
photo-53.jpg,1,1943,1966,569,626,4.80,3264,2448,23,57
photo-54.jpg,2,1110,1150,1317,2025,45x11 Ogm CAVOS CHICKEN BREAST BURGERS,3264,2448,40,708
photo-54.jpg,1,1094,1120,524,596,54.00,3264,2448,26,72
photo-54.jpg,1,1106,1131,1096,1173,1.000,3264,2448,25,77
photo-54.jpg,1,1104,1130,964,1040,54.00,3264,2448,26,76
photo-54.jpg,1,1104,1127,806,862,0.00,3264,2448,23,56
photo-54.jpg,1,1101,1124,675,730,0.00,3264,2448,23,55
photo-54.jpg,3,1127,1149,2174,2213,BB,3264,2448,22,39
photo-55.jpg,2,1083,1120,1479,2202,FOTFRESHGT 2kg GC FRESH FILLET OF THIGH,3264,2448,37,723
photo-55.jpg,3,1071,1100,439,519,l&QO,3264,2448,29,80
photo-55.jpg,1,1079,1107,1041,1119,1.000,3264,2448,28,78
photo-55.jpg,1,1076,1106,901,981,99.00,3264,2448,30,80
photo-55.jpg,1,1077,1104,738,799,0.00,3264,2448,27,61
photo-55.jpg,3,1076,1101,598,660,"0,00",3264,2448,25,62
photo-56.jpg,2,1035,1073,1453,1987,192x35gmAC WHITE DINNER ROLL,3264,2448,38,534
photo-56.jpg,2,1083,1119,1565,1990,2.5kg KR RINDLESS BACON,3264,2448,36,425
photo-56.jpg,2,1127,1165,1473,1989,2kg WFG FRESH MINCED GARLIC,3264,2448,38,516
photo-56.jpg,2,1174,1211,1485,2185,CORFLA260 260gm FREEDOM CORN FLAKES,3264,2448,37,700
photo-56.jpg,2,1216,1256,1229,1988,500gm FREEDOM GF/WF MUESLI WITH PSYLLIUM,3264,2448,40,759
photo-56.jpg,2,1265,1303,1473,2183,CAKMIX375C375gm ORGRAN CHOC CAKE MIX,3264,2448,38,710
photo-56.jpg,2,1310,1349,1439,2182,CAKMIX375V375gm ORGRAN VANILLA CAKE MIX,3264,2448,39,743
photo-56.jpg,2,1353,1396,1243,2182,CAKMIX45OM450gm NATURALLY GOOD CHOC MUD CAKE MIX,3264,2448,43,939
photo-56.jpg,2,1399,1442,1218,2181,PANMIX375A 375gm ORGRAN APPLE/CINNAMON PANCAKE MIX,3264,2448,43,963
photo-56.jpg,2,1448,1489,1414,2180,EGGPLA200 200gm ORGRAN NO EGG REPLACER,3264,2448,41,766
photo-56.jpg,2,1497,1535,1524,1986,200gm ORGRAN FALAFEL MIX,3264,2448,38,462
photo-56.jpg,2,1545,1578,1590,1986,2.4lt BERRI APPLE JUICE-,3264,2448,33,396
photo-56.jpg,2,1589,1625,1519,1985,211 GC PET BREAKFAST JUICE,3264,2448,36,466
photo-56.jpg,2,1637,1673,1562,1986,2lt GC PET ORANGE JUICE,3264,2448,36,424
photo-56.jpg,2,1684,1726,1506,1987,6x1 kg KELLOGGS COCO POPS,3264,2448,42,481
photo-56.jpg,2,1732,1773,1510,1987,6x1 kg KELLOGGS JUST RIGHT,3264,2448,41,477
photo-56.jpg,2,1779,1822,1534,1984,12.5kg SELF RAISING FLOUR,3264,2448,43,450
photo-56.jpg,2,1829,1868,1663,1984,12.5kg PLAIN FLOUR,3264,2448,39,321
photo-56.jpg,2,1872,1911,1487,1987,20lt SOLERO COTTONSEED OIL,3264,2448,39,500
photo-56.jpg,3,1089,1113,2059,2183,BACEVE,3264,2448,24,124
photo-56.jpg,3,1136,1160,2035,2183,GARLICW,3264,2448,24,148
photo-56.jpg,3,1228,1253,2059,2183,MUE500*,3264,2448,25,124
photo-56.jpg,1,1043,1067,2131,2183,059,3264,2448,24,52
photo-56.jpg,1,1031,1057,1041,1117,1.000,3264,2448,26,76
photo-56.jpg,1,1029,1055,904,980,32.70,3264,2448,26,76
photo-56.jpg,1,1076,1102,1040,1118,6.000,3264,2448,26,78
photo-56.jpg,1,1074,1100,902,979,23.20,3264,2448,26,77
photo-56.jpg,1,1121,1148,1038,1115,1.000,3264,2448,27,77
photo-56.jpg,1,1120,1146,902,976,11.00,3264,2448,26,74
photo-56.jpg,1,1168,1194,1037,1116,2.000,3264,2448,26,79
photo-56.jpg,1,1214,1240,1036,1114,2.000,3264,2448,26,78
photo-56.jpg,1,1212,1238,899,959,6.40,3264,2448,26,60
photo-56.jpg,1,1260,1285,1030,1112,8.000.,3264,2448,25,82
photo-56.jpg,1,1257,1283,898,957,4.20,3264,2448,26,59
photo-56.jpg,1,1305,1331,1034,1111,8.000,3264,2448,26,77
photo-56.jpg,1,1303,1329,896,956,4.20,3264,2448,26,60
photo-56.jpg,1,1350,1376,1032,1111,4.000,3264,2448,26,79
photo-56.jpg,1,1349,1375,894,953,5.00,3264,2448,26,59
photo-56.jpg,1,1396,1423,1030,1107,8.000,3264,2448,27,77
photo-56.jpg,1,1395,1420,892,951,3.50,3264,2448,25,59
photo-56.jpg,1,1442,1469,1029,1106,8.000,3264,2448,27,77
photo-56.jpg,1,1440,1466,891,949,3.80,3264,2448,26,58
photo-56.jpg,1,1488,1515,1027,1104,8.000,3264,2448,27,77
photo-56.jpg,1,1486,1512,889,947,3.70,3264,2448,26,58
photo-56.jpg,1,1534,1562,1025,1103,6.000,3264,2448,28,78
photo-56.jpg,1,1532,1558,887,946,4.50,3264,2448,26,59
photo-56.jpg,1,1581,1608,1023,1102,6.000,3264,2448,27,79
photo-56.jpg,1,1578,1604,885,945,4.20,3264,2448,26,60
photo-56.jpg,1,1628,1656,1022,1102,6.000,3264,2448,28,80
photo-56.jpg,1,1624,1652,874,945,3.30.,3264,2448,28,71
photo-56.jpg,1,1674,1702,1022,1099,1.000,3264,2448,28,77
photo-56.jpg,3,1670,1699,883,969,'71.70,3264,2448,29,86
photo-56.jpg,1,1721,1748,1020,1098,1.000,3264,2448,27,78
photo-56.jpg,1,1719,1746,882,959,64.70,3264,2448,27,77
photo-56.jpg,1,1768,1795,1019,1096,1.000,3264,2448,27,77
photo-56.jpg,3,1765,1794,879,984,. 13.20,3264,2448,29,105
photo-56.jpg,1,1815,1843,1017,1094,1.000,3264,2448,28,77
photo-56.jpg,1,1812,1840,878,954,13.20,3264,2448,28,76
photo-56.jpg,1,1859,1889,1015,1094,2.000,3264,2448,30,79
photo-56.jpg,1,1858,1888,875,954,50.00,3264,2448,30,79
photo-56.jpg,1,1025,1051,605,663,0.00,3264,2448,26,58
photo-56.jpg,1,1021,1048,449,525,32.70,3264,2448,27,76
photo-56.jpg,1,1071,1097,604,662,0.00,3264,2448,26,58
photo-56.jpg,1,1066,1093,446,539,139.20,3264,2448,27,93
photo-56.jpg,1,1030,1053,742,798,0.00,3264,2448,23,56
photo-56.jpg,1,1075,1098,740,798,0.00,3264,2448,23,58
photo-56.jpg,1,1112,1138,446,520,11.00,3264,2448,26,74
photo-56.jpg,1,1121,1143,739,796,0.00,3264,2448,22,57
photo-56.jpg,1,1117,1142,602,659,0.00,3264,2448,25,57
photo-56.jpg,1,1166,1193,900,961,4.05,3264,2448,27,61
photo-56.jpg,1,1157,1183,442,503,8.10,3264,2448,26,61
photo-56.jpg,1,1166,1189,737,796,0.00,3264,2448,23,59
photo-56.jpg,1,1162,1188,601,660,0.00,3264,2448,26,59
photo-56.jpg,1,1202,1230,442,518,12.80,3264,2448,28,76
photo-56.jpg,1,1247,1275,441,518,33.60,3264,2448,28,77
photo-56.jpg,1,1292,1320,438,515,33.60,3264,2448,28,77
photo-56.jpg,1,1338,1366,437,514,20.00,3264,2448,28,77
photo-56.jpg,1,1384,1411,434,510,28.00,3264,2448,27,76
photo-56.jpg,1,1429,1458,432,509,30.40,3264,2448,29,77
photo-56.jpg,1,1475,1503,430,506,29.60,3264,2448,28,76
photo-56.jpg,1,1521,1549,427,505,27.00,3264,2448,28,78
photo-56.jpg,1,1567,1594,425,504,25.20,3264,2448,27,79
photo-56.jpg,1,1613,1642,423,501,19.60,3264,2448,29,78
photo-56.jpg,1,1660,1688,421,501,71.70,3264,2448,28,80
photo-56.jpg,1,1707,1734,419,498,64.70,3264,2448,27,79
photo-56.jpg,1,1753,1781,417,494,13.20,3264,2448,28,77
photo-56.jpg,1,1800,1827,414,491,13.20,3264,2448,27,77
photo-56.jpg,1,1847,1875,412,507,100.00,3264,2448,28,95
photo-56.jpg,1,1212,1235,737,794,0.00,3264,2448,23,57
photo-56.jpg,1,1208,1233,600,657,0.00,3264,2448,25,57
photo-56.jpg,1,1257,1280,735,792,0.00,3264,2448,23,57
photo-56.jpg,1,1254,1278,599,656,0.00,3264,2448,24,57
photo-56.jpg,1,1303,1326,734,790,0.00,3264,2448,23,56
photo-56.jpg,1,1299,1323,597,653,0.00,3264,2448,24,56
photo-56.jpg,1,1349,1372,732,789,0.00,3264,2448,23,57
photo-56.jpg,1,1345,1368,594,652,0.00,3264,2448,23,58
photo-56.jpg,1,1394,1417,730,786,0.00,3264,2448,23,56
photo-56.jpg,1,1390,1413,593,649,0.00,3264,2448,23,56
photo-56.jpg,3,1509,1535,2018,2180,FALMIX200,3264,2448,26,162
photo-56.jpg,3,1558,1583,2060,2180,FJ2.4BA,3264,2448,25,120
photo-56.jpg,1,1440,1464,728,785,0.00,3264,2448,24,57
photo-56.jpg,1,1436,1459,590,647,0.00,3264,2448,23,57
photo-56.jpg,1,1486,1510,726,782,0.00,3264,2448,24,56
photo-56.jpg,1,1482,1505,589,645,0.00,3264,2448,23,56
photo-56.jpg,1,1532,1554,724,781,0.00,3264,2448,22,57
photo-56.jpg,1,1528,1551,586,643,0.00,3264,2448,23,57
photo-56.jpg,3,1603,1630,2065,2180,FJ2BRE,3264,2448,27,115
photo-56.jpg,3,1651,1678,2060,2182,FJ20RA,3264,2448,27,122
photo-56.jpg,3,1699,1726,2030,2183,COCPOP6,3264,2448,27,153
photo-56.jpg,3,1748,1774,2055,2184,JUSRIG1,3264,2448,26,129
photo-56.jpg,3,1793,1822,2022,2183,SELFLOCL,3264,2448,29,161
photo-56.jpg,3,1841,1870,2021,2183,PLAFLOCL,3264,2448,29,162
photo-56.jpg,3,1891,1918,2046,2185,COTOILS,3264,2448,27,139
photo-56.jpg,1,1578,1601,722,779,0.00,3264,2448,23,57
photo-56.jpg,1,1573,1597,584,642,0.00,3264,2448,24,58
photo-56.jpg,1,1621,1644,583,641,0.00,3264,2448,23,58
photo-56.jpg,1,1624,1648,721,779,0.00,3264,2448,24,58
photo-56.jpg,1,1667,1690,581,639,0.00,3264,2448,23,58
photo-56.jpg,1,1670,1694,720,777,0.00,3264,2448,24,57
photo-56.jpg,1,1713,1737,579,637,0.00,3264,2448,24,58
photo-56.jpg,1,1717,1741,717,775,0.00,3264,2448,24,58
photo-56.jpg,1,1761,1784,577,635,0.00,3264,2448,23,58
photo-56.jpg,1,1764,1787,715,773,0.00,3264,2448,23,58
photo-56.jpg,1,1811,1834,713,771,0.00,3264,2448,23,58
photo-56.jpg,1,1807,1831,575,635,0.00,3264,2448,24,60
photo-56.jpg,1,1857,1882,710,769,0.00,3264,2448,25,59
photo-56.jpg,1,1854,1878,572,630,0.00,3264,2448,24,58
photo-58.jpg,2,1278,1304,1442,1847,Gloves VINYL Low Powder Med,2448,3264,26,405
photo-58.jpg,2,1331,1357,1456,1847,Gloves VINYL Low Powder XL,2448,3264,26,391
photo-58.jpg,2,1385,1412,1430,1848,Gloves VINYL Low Powder Large,2448,3264,27,418
photo-58.jpg,2,1437,1467,1269,1848,Docket Book 132 Dup Carbonless 50pg. T/Away,2448,3264,30,579
photo-58.jpg,2,1491,1522,1434,1848,Singlet Bags White Medium - 250's,2448,3264,31,414
photo-58.jpg,2,1546,1572,1398,1848,Pizza Box Brown 15 Perfect Bite 50's,2448,3264,26,450
photo-58.jpg,2,1603,1626,1651,1848,Pizza Box Pillars,2448,3264,23,197
photo-58.jpg,2,1655,1680,1433,1849,Food Bowl 20oz Dome Lid Mar 50,2448,3264,25,416
photo-58.jpg,2,1711,1734,1496,1849,Brilliant Auto Dish Wash 20L,2448,3264,23,353
photo-58.jpg,1,1268,1294,783,852,$9.00,2448,3264,26,69
photo-58.jpg,3,1272,1296,1056,1203,23-GVMLP,2448,3264,24,147
photo-58.jpg,1,1266,1291,609,679,$0.90,2448,3264,25,70
photo-58.jpg,1,1263,1288,433,505,$9.90,2448,3264,25,72
photo-58.jpg,1,1283,1305,2040,2057,2,2448,3264,22,17
photo-58.jpg,1,1323,1347,782,866,$27.00,2448,3264,24,84
photo-58.jpg,3,1326,1350,1044,1203,23-GVXLLP,2448,3264,24,159
photo-58.jpg,1,1321,1345,608,678,$2.70,2448,3264,24,70
photo-58.jpg,1,1316,1342,432,518,$29.70,2448,3264,26,86
photo-58.jpg,1,1337,1358,2041,2057,6,2448,3264,21,16
photo-58.jpg,1,1376,1401,782,850,$9.00,2448,3264,25,68
photo-58.jpg,3,1379,1403,1066,1203,23-GVLLP,2448,3264,24,137
photo-58.jpg,1,1374,1400,607,677,$0.90,2448,3264,26,70
photo-58.jpg,1,1390,1411,2042,2058,2,2448,3264,21,16
photo-58.jpg,1,1372,1396,432,501,$9.90,2448,3264,24,69
photo-58.jpg,1,1430,1455,781,850,$7.20,2448,3264,25,69
photo-58.jpg,3,1433,1457,1076,1199,19-RD132,2448,3264,24,123
photo-58.jpg,1,1429,1454,608,677,$0.72,2448,3264,25,69
photo-58.jpg,1,1444,1466,2042,2059,6,2448,3264,22,17
photo-58.jpg,1,1426,1451,431,501,$7.92,2448,3264,25,70
photo-58.jpg,1,1485,1509,781,848,$4.15,2448,3264,24,67
photo-58.jpg,3,1487,1510,1086,1199,12-MCW,2448,3264,23,113
photo-58.jpg,1,1483,1507,606,675,$0.42,2448,3264,24,69
photo-58.jpg,3,1497,1518,2048,2055,I,2448,3264,21,7
photo-58.jpg,1,1480,1505,430,499,$4.57,2448,3264,25,69
photo-58.jpg,1,1540,1565,780,877,$124.25,2448,3264,25,97
photo-58.jpg,3,1543,1566,1051,1203,08-PIZ15PB,2448,3264,23,152
photo-58.jpg,1,1538,1563,606,689,$12.43,2448,3264,25,83
photo-58.jpg,1,1552,1573,2046,2060,5,2448,3264,21,14
photo-58.jpg,1,1536,1561,429,530,$136.68,2448,3264,25,101
photo-58.jpg,1,1595,1620,779,862,$47.45,2448,3264,25,83
photo-58.jpg,3,1598,1621,1041,1202,08-PILLARS,2448,3264,23,161
photo-58.jpg,1,1593,1618,605,674,$4.75,2448,3264,25,69
photo-58.jpg,1,1606,1627,2049,2058,1,2448,3264,21,9
photo-58.jpg,1,1591,1618,426,513,$52.20,2448,3264,27,87
photo-58.jpg,1,1650,1675,778,860,$16.55,2448,3264,25,82
photo-58.jpg,3,1653,1676,984,1201,04-6620DLMAR.,2448,3264,23,217
photo-58.jpg,1,1648,1673,602,672,$1.66,2448,3264,25,70
photo-58.jpg,3,1660,1682,2049,2057,I,2448,3264,22,8
photo-58.jpg,1,1647,1671,430,511,$18.21,2448,3264,24,81
photo-58.jpg,1,1704,1729,776,860,$77.00,2448,3264,25,84
photo-58.jpg,3,1707,1730,1090,1201,01-CB20,2448,3264,23,111
photo-58.jpg,1,1714,1734,1922,1930,1,2448,3264,20,8
photo-58.jpg,1,1702,1728,601,671,$7.70,2448,3264,26,70
photo-58.jpg,1,1701,1726,423,509,$84.70,2448,3264,25,86
photo-59.jpg,2,1135,1159,1699,1909,Pizza Box Pillars,2448,3264,24,210
photo-59.jpg,2,1189,1217,1479,1909,Gloves Low Powder VINYL Med,2448,3264,28,430
photo-59.jpg,2,1246,1275,1464,1908,Gloves Low Powder VINYL XLge,2448,3264,29,444
photo-59.jpg,2,1302,1332,1466,1909,Gloves Low Powder VINYL Large,2448,3264,30,443
photo-59.jpg,2,1355,1390,1294,1908,Docket Book 132 Dup Carbonless 50pg. T/Away,2448,3264,35,614
photo-59.jpg,2,1414,1443,1428,1908,Pizza Box Brown 15 Perfect Bite 50's,2448,3264,29,480
photo-59.jpg,2,1470,1501,1432,1906,Genfac Round LID suit 70-150ml 50's,2448,3264,31,474
photo-59.jpg,2,1529,1558,1471,1906,Genfac Round 70ml Container 50's,2448,3264,29,435
photo-59.jpg,2,1586,1622,1489,1905,Supremo Heavy Duty Cleaner 5L,2448,3264,36,416
photo-59.jpg,2,1644,1676,1579,1906,Green Clean Detergent 5L,2448,3264,32,327
photo-59.jpg,2,1703,1731,1678,1906,Jet Rinse Aid 20L,2448,3264,28,228
photo-59.jpg,3,1112,1137,428,518,S52.20,2448,3264,25,90
photo-59.jpg,1,1121,1147,792,879,$47.45,2448,3264,26,87
photo-59.jpg,3,1126,1151,1062,1229,08-PILLARS,2448,3264,25,167
photo-59.jpg,1,1119,1144,612,684,$4.75,2448,3264,25,72
photo-59.jpg,3,1139,1160,1986,1994,I,2448,3264,21,8
photo-59.jpg,1,1169,1195,428,501,$4.95,2448,3264,26,73
photo-59.jpg,1,1177,1203,789,862,$4.50,2448,3264,26,73
photo-59.jpg,1,1198,1220,2122,2130,1,2448,3264,22,8
photo-59.jpg,3,1183,1207,1074,1228,23-GVMLP,2448,3264,24,154
photo-59.jpg,1,1175,1200,610,683,$0.45,2448,3264,25,73
photo-59.jpg,1,1225,1252,426,515,$24.75,2448,3264,27,89
photo-59.jpg,1,1233,1259,788,875,$22.50,2448,3264,26,87
photo-59.jpg,1,1254,1278,2118,2134,5,2448,3264,24,16
photo-59.jpg,3,1239,1263,1060,1227,23-GVXLLP,2448,3264,24,167
photo-59.jpg,1,1231,1257,610,681,$2.25,2448,3264,26,71
photo-59.jpg,1,1282,1309,424,498,$4.95,2448,3264,27,74
photo-59.jpg,1,1290,1316,788,859,$4.50,2448,3264,26,71
photo-59.jpg,3,1296,1321,1084,1227,23-GVLLP,2448,3264,25,143
photo-59.jpg,3,1311,1334,2123,2130,I,2448,3264,23,7
photo-59.jpg,3,1288,1313,608,680,S0.45,2448,3264,25,72
photo-59.jpg,1,1339,1365,423,496,$3.96,2448,3264,26,73
photo-59.jpg,1,1346,1371,786,857,$3.60,2448,3264,25,71
photo-59.jpg,1,1366,1390,2119,2134,3,2448,3264,24,15
photo-59.jpg,3,1351,1376,1092,1221,I9-RD132,2448,3264,25,129
photo-59.jpg,1,1344,1369,605,678,$0.36,2448,3264,25,73
photo-59.jpg,3,1397,1423,426,580,_ $164.01,2448,3264,26,154
photo-59.jpg,1,1402,1429,785,887,$149.10,2448,3264,27,102
photo-59.jpg,3,1408,1433,1067,1225,08-PIZ15PB,2448,3264,25,158
photo-59.jpg,1,1423,1448,2118,2134,6,2448,3264,25,16
photo-59.jpg,1,1401,1426,609,692,$14.91,2448,3264,25,83
photo-59.jpg,1,1453,1480,419,493,$2.64,2448,3264,27,74
photo-59.jpg,1,1460,1485,783,855,$2.40,2448,3264,25,72
photo-59.jpg,3,1464,1491,996,1224,03-GRLID70-150,2448,3264,27,228
photo-59.jpg,1,1481,1505,2122,2130,1,2448,3264,24,8
photo-59.jpg,1,1458,1485,602,676,$0.24,2448,3264,27,74
photo-59.jpg,1,1515,1541,601,674,$0.35,2448,3264,26,73
photo-59.jpg,3,1568,1599,598,673,|L90,2448,3264,31,75
photo-59.jpg,1,1510,1535,418,491,$3.85,2448,3264,25,73
photo-59.jpg,1,1516,1542,781,854,$3.50,2448,3264,26,73
photo-59.jpg,3,1522,1547,1104,1223,03-GR70,2448,3264,25,119
photo-59.jpg,1,1539,1562,2122,2129,1,2448,3264,23,7
photo-59.jpg,1,1568,1594,417,505,$20.85,2448,3264,26,88
photo-59.jpg,1,1574,1600,781,868,$18.95,2448,3264,26,87
photo-59.jpg,3,1579,1606,1083,1222,01-CSUP5,2448,3264,27,139
photo-59.jpg,1,1596,1621,2120,2130,1,2448,3264,25,10
photo-59.jpg,3,1624,1651,413,503,SI 1.66,2448,3264,27,90
photo-59.jpg,1,1630,1657,778,866,$10.60,2448,3264,27,88
photo-59.jpg,3,1636,1663,1098,1221,01-CGC5,2448,3264,27,123
photo-59.jpg,1,1628,1655,598,671,$1.06,2448,3264,27,73
photo-59.jpg,1,1654,1678,2121,2129,1,2448,3264,24,8
photo-59.jpg,1,1682,1708,411,501,$84.70,2448,3264,26,90
photo-59.jpg,1,1688,1715,777,864,$77.00,2448,3264,27,87
photo-59.jpg,3,1694,1720,1091,1220,01-CJR20,2448,3264,26,129
photo-59.jpg,1,1686,1713,595,668,$7.70,2448,3264,27,73
photo-59.jpg,1,1709,1732,1983,1991,1,2448,3264,23,8
photo-59.jpg,1,1739,1767,409,498,$84.70,2448,3264,28,89
photo-59.jpg,3,1745,1772,775,863,S77.00,2448,3264,27,88
photo-59.jpg,3,1751,1778,1102,1219,01-CB20,2448,3264,27,117
photo-59.jpg,1,1743,1770,593,667,$7.70,2448,3264,27,74
photo-60.jpg,2,1149,1178,1464,1906,Gloves Low Powder VINYL Large,2448,3264,29,442
photo-60.jpg,2,1205,1235,1464,1906,Gloves Low Powder VINYL XLge,2448,3264,30,442
photo-60.jpg,2,1262,1287,1478,1907,Gloves Low Powder VINYL Med,2448,3264,25,429
photo-60.jpg,2,1316,1349,1295,1906,Docket Book 132 Dup Carbonless 50pg. T/Away,2448,3264,33,611
photo-60.jpg,2,1374,1406,1465,1906,Dispenser Napkin Capri DFold 250,2448,3264,32,441
photo-60.jpg,2,1430,1457,1431,1908,Pizza Box Brown 15 Perfect Bite 50's,2448,3264,27,477
photo-60.jpg,2,1488,1514,1469,1908,Food Bowl 20oz Dome Lid Mar 50,2448,3264,26,439
photo-60.jpg,2,1546,1578,1560,1908,Wipes H.D. Roll BLUE CA,2448,3264,32,348
photo-60.jpg,1,1135,1161,422,495,$9.90,2448,3264,26,73
photo-60.jpg,1,1139,1166,605,678,$0.90,2448,3264,27,73
photo-60.jpg,1,1196,1223,606,678,$2.25,2448,3264,27,72
photo-60.jpg,1,1253,1279,606,677,$0.45,2448,3264,26,71
photo-60.jpg,1,1142,1167,786,857,$9.00,2448,3264,25,71
photo-60.jpg,3,1144,1168,1083,1225,23-GVLLP,2448,3264,24,142
photo-60.jpg,1,1148,1172,2115,2131,2,2448,3264,24,16
photo-60.jpg,1,1192,1219,423,511,$24.75,2448,3264,27,88
photo-60.jpg,3,1200,1225,1059,1225,23-GVXLLP,2448,3264,25,166
photo-60.jpg,1,1198,1224,786,873,$22.50,2448,3264,26,87
photo-60.jpg,1,1205,1229,2116,2131,5,2448,3264,24,15
photo-60.jpg,1,1249,1275,423,494,$4.95,2448,3264,26,71
photo-60.jpg,1,1256,1280,786,857,$4.50,2448,3264,24,71
photo-60.jpg,3,1257,1282,1072,1225,23-GVMLP,2448,3264,25,153
photo-60.jpg,1,1263,1286,2120,2129,1,2448,3264,23,9
photo-60.jpg,1,1306,1332,419,509,$13.20,2448,3264,26,90
photo-60.jpg,1,1310,1336,603,676,$1.20,2448,3264,26,73
photo-60.jpg,1,1367,1394,605,675,$0.35,2448,3264,27,70
photo-60.jpg,1,1424,1450,604,691,$12.43,2448,3264,26,87
photo-60.jpg,1,1482,1507,602,674,$1.66,2448,3264,25,72
photo-60.jpg,3,1314,1338,1092,1219,19-RDI32,2448,3264,24,127
photo-60.jpg,1,1312,1337,785,872,$12.00,2448,3264,25,87
photo-60.jpg,1,1320,1343,2107,2136,10,2448,3264,23,29
photo-60.jpg,1,1363,1389,421,493,$3.85,2448,3264,26,72
photo-60.jpg,3,1371,1396,1047,1220,15-C-ND0I51,2448,3264,25,173
photo-60.jpg,1,1369,1394,784,855,$3.50,2448,3264,25,71
photo-60.jpg,1,1376,1399,2116,2133,2,2448,3264,23,17
photo-60.jpg,1,1421,1447,420,524,$136.68,2448,3264,26,104
photo-60.jpg,1,1426,1452,785,887,$124.25,2448,3264,26,102
photo-60.jpg,3,1428,1454,1067,1225,08-PIZ15PB,2448,3264,26,158
photo-60.jpg,1,1433,1458,2118,2133,5,2448,3264,25,15
photo-60.jpg,1,1478,1504,423,508,$18.21,2448,3264,26,85
photo-60.jpg,3,1485,1510,999,1224,04-6620DLMAR.,2448,3264,25,225
photo-60.jpg,1,1484,1509,785,871,$16.55,2448,3264,25,86
photo-60.jpg,1,1491,1514,2122,2130,1,2448,3264,23,8
photo-60.jpg,1,1536,1563,416,506,$20.96,2448,3264,27,90
photo-60.jpg,1,1539,1564,605,673,$1.91,2448,3264,25,68
photo-60.jpg,3,1543,1569,1003,1224,02-CAWIPEBlue,2448,3264,26,221
photo-60.jpg,1,1541,1567,783,869,$19.05,2448,3264,26,86
photo-60.jpg,3,1550,1572,2122,2130,I,2448,3264,22,8
photo-61.jpg,2,1203,1226,1516,1937,Gloves Low Powder VINYL Med,2448,3264,23,421
photo-61.jpg,2,1260,1290,1502,1937,Gloves Low Powder VINYL XLge,2448,3264,30,435
photo-61.jpg,2,1316,1346,1502,1937,Gloves Low Powder VINYL Large,2448,3264,30,435
photo-61.jpg,2,1372,1402,1335,1936,Docket Book 132 Dup Carbonless 50pg. T/Away,2448,3264,30,601
photo-61.jpg,2,1428,1457,1506,1936,Singlet Bags White Medium - 250's,2448,3264,29,430
photo-61.jpg,2,1484,1508,1468,1936,Pizza Box Brown 15 Perfect Bite 50's,2448,3264,24,468
photo-61.jpg,2,1541,1563,1730,1936,Pizza Box Pillars,2448,3264,22,206
photo-61.jpg,1,1202,1224,2145,2160,2,2448,3264,22,15
photo-61.jpg,3,1205,1226,1115,1265,23-GVMLP,2448,3264,21,150
photo-61.jpg,1,1204,1227,833,902,$9.00,2448,3264,23,69
photo-61.jpg,3,1203,1225,476,547,S9.90,2448,3264,22,71
photo-61.jpg,1,1204,1226,655,725,$0.90,2448,3264,22,70
photo-61.jpg,1,1259,1281,2146,2160,5,2448,3264,22,14
photo-61.jpg,3,1261,1282,1102,1265,23-GVXLLP,2448,3264,21,163
photo-61.jpg,1,1259,1283,832,918,$22.50,2448,3264,24,86
photo-61.jpg,1,1260,1283,656,725,$2.25,2448,3264,23,69
photo-61.jpg,3,1260,1282,477,562,S24.75,2448,3264,22,85
photo-61.jpg,1,1316,1337,2146,2161,2,2448,3264,21,15
photo-61.jpg,3,1316,1339,1125,1265,23-GVLLP,2448,3264,23,140
photo-61.jpg,1,1316,1338,833,902,$9.00,2448,3264,22,69
photo-61.jpg,1,1316,1338,655,725,$0.90,2448,3264,22,70
photo-61.jpg,3,1316,1338,476,546,S9.90,2448,3264,22,70
photo-61.jpg,1,1371,1393,2145,2160,6,2448,3264,22,15
photo-61.jpg,3,1373,1395,1135,1260,19-RD132,2448,3264,22,125
photo-61.jpg,1,1372,1395,831,901,$7.20,2448,3264,23,70
photo-61.jpg,1,1372,1394,654,724,$0.72,2448,3264,22,70
photo-61.jpg,3,1371,1393,475,545,S7.92,2448,3264,22,70
photo-61.jpg,1,1428,1450,2149,2156,1,2448,3264,22,7
photo-61.jpg,3,1429,1450,1146,1261,12-MCW,2448,3264,21,115
photo-61.jpg,3,1427,1449,475,545,S4.57,2448,3264,22,70
photo-61.jpg,1,1428,1450,833,901,$4.15,2448,3264,22,68
photo-61.jpg,1,1427,1450,655,724,$0.42,2448,3264,23,69
photo-61.jpg,1,1485,1506,2146,2161,4,2448,3264,21,15
photo-61.jpg,3,1485,1507,1111,1265,08-PIZ15PB,2448,3264,22,154
photo-61.jpg,1,1483,1505,474,576,$10934,2448,3264,22,102
photo-61.jpg,1,1484,1506,831,916,$99.40,2448,3264,22,85
photo-61.jpg,1,1483,1505,654,724,$9.94,2448,3264,22,70
photo-61.jpg,3,1541,1562,2151,2157,I,2448,3264,21,6
photo-61.jpg,3,1540,1563,1101,1265,08-PILLARS,2448,3264,23,164
photo-61.jpg,3,1539,1561,654,723,S4.75,2448,3264,22,69
photo-61.jpg,1,1539,1561,474,560,$52.20,2448,3264,22,86
photo-61.jpg,3,1539,1562,832,916,S47.45,2448,3264,23,84
photo-62.jpg,2,1211,1239,1481,1901,Masking Tape 24mm X 50m Each,2448,3264,28,420
photo-62.jpg,2,1267,1298,1462,1902,Gloves Low Powder VINYL Large,2448,3264,31,440
photo-62.jpg,2,1324,1354,1463,1903,Gloves Low Powder VINYL XLge,2448,3264,30,440
photo-62.jpg,2,1381,1412,1295,1903,Docket Book 132 Dup Carbonless 50pg. T/Away,2448,3264,31,608
photo-62.jpg,2,1438,1461,1429,1904,Pizza Box Brown 9 Perfect Bite 100's,2448,3264,23,475
photo-62.jpg,2,1495,1524,1446,1902,Bin Liner 82L HD Handy Pack 100's,2448,3264,29,456
photo-62.jpg,2,1551,1575,1429,1902,Pizza Box Brown 15” Perfect Bite 50's,2448,3264,24,473
photo-62.jpg,2,1608,1638,1443,1903,Square 4.5L Container With Lid Each,2448,3264,30,460
photo-62.jpg,2,1666,1695,1430,1903,Square 3.15L Container With Lid Each,2448,3264,29,473
photo-62.jpg,2,1723,1753,1570,1903,Stainless Steel Scourer 50g,2448,3264,30,333
photo-62.jpg,2,1780,1803,1648,1903,Green Scourer Small,2448,3264,23,255
photo-62.jpg,3,1213,1235,1090,1223,25-MASK,2448,3264,22,133
photo-62.jpg,1,1213,1237,422,494,$5.50,2448,3264,24,72
photo-62.jpg,1,1209,1230,2117,2124,1,2448,3264,21,7
photo-62.jpg,1,1215,1238,786,855,$5.00,2448,3264,23,69
photo-62.jpg,1,1216,1238,605,676,$0.50,2448,3264,22,71
photo-62.jpg,3,1271,1295,379,510,S14.85 S,2448,3264,24,131
photo-62.jpg,1,1265,1288,2114,2127,3,2448,3264,23,13
photo-62.jpg,3,1271,1292,1081,1223,23-GVLLP,2448,3264,21,142
photo-62.jpg,3,1272,1294,785,871,SI 3.50,2448,3264,22,86
photo-62.jpg,3,1273,1295,607,676,SI.35,2448,3264,22,69
photo-62.jpg,1,1324,1345,2113,2128,6,2448,3264,21,15
photo-62.jpg,3,1328,1349,1057,1223,23-GVXLLP,2448,3264,21,166
photo-62.jpg,3,1329,1351,785,871,S27.00,2448,3264,22,86
photo-62.jpg,3,1329,1352,422,510,S29.70,2448,3264,23,88
photo-62.jpg,1,1329,1353,605,676,$2.70,2448,3264,24,71
photo-62.jpg,1,1381,1402,2115,2128,5,2448,3264,21,13
photo-62.jpg,3,1385,1407,1091,1220,19-RD132,2448,3264,22,129
photo-62.jpg,3,1386,1408,785,855,S6.00,2448,3264,22,70
photo-62.jpg,3,1386,1409,422,494,S6.60,2448,3264,23,72
photo-62.jpg,1,1387,1410,606,676,$0.60,2448,3264,23,70
photo-62.jpg,3,1440,1463,1082,1224,08-PIZ9PB,2448,3264,23,142
photo-62.jpg,1,1437,1458,2118,2124,1,2448,3264,21,6
photo-62.jpg,3,1442,1465,786,871,S24.20,2448,3264,23,85
photo-62.jpg,1,1443,1466,424,510,$26.62,2448,3264,23,86
photo-62.jpg,1,1500,1523,424,510,$20.02,2448,3264,23,86
photo-62.jpg,1,1443,1465,605,676,$2.42,2448,3264,22,71
photo-62.jpg,1,1495,1515,2119,2125,1,2448,3264,20,6
photo-62.jpg,3,1498,1520,1013,1220,12-LDBIN82HP,2448,3264,22,207
photo-62.jpg,3,1498,1522,785,871,S18.20,2448,3264,24,86
photo-62.jpg,1,1499,1522,606,676,$1.82,2448,3264,23,70
photo-62.jpg,1,1551,1572,2115,2129,5,2448,3264,21,14
photo-62.jpg,3,1554,1577,1067,1224,08-PIZ15PB,2448,3264,23,157
photo-62.jpg,3,1556,1577,787,886,SI 24.25,2448,3264,21,99
photo-62.jpg,3,1556,1579,606,691,S12.43,2448,3264,23,85
photo-62.jpg,3,1556,1579,424,527,SI 36.68,2448,3264,23,103
photo-62.jpg,1,1607,1631,2116,2130,3,2448,3264,24,14
photo-62.jpg,3,1610,1639,1042,1225,03-PCSQ4.5L,2448,3264,29,183
photo-62.jpg,3,1669,1697,1028,1225,03-PCSQ3.15L,2448,3264,28,197
photo-62.jpg,3,1726,1749,1130,1225,02-SSS,2448,3264,23,95
photo-62.jpg,3,1612,1635,784,856,S7.20,2448,3264,23,72
photo-62.jpg,3,1613,1636,604,677,S0.72,2448,3264,23,73
photo-62.jpg,3,1614,1637,423,495,S7.92,2448,3264,23,72
photo-62.jpg,1,1665,1688,2117,2130,3,2448,3264,23,13
photo-62.jpg,3,1670,1692,786,856,S6.30,2448,3264,22,70
photo-62.jpg,3,1671,1693,607,677,S0.63,2448,3264,22,70
photo-62.jpg,3,1671,1693,425,495,S6.93,2448,3264,22,70
photo-62.jpg,1,1722,1745,2117,2131,2,2448,3264,23,14
photo-62.jpg,3,1727,1749,786,856,S4.40,2448,3264,22,70
photo-62.jpg,3,1727,1750,606,677,S0.44,2448,3264,23,71
photo-62.jpg,1,1727,1751,424,495,$4.84,2448,3264,24,71
photo-62.jpg,1,1781,1802,2116,2131,4,2448,3264,21,15
photo-62.jpg,3,1783,1806,1124,1225,02-GSS,2448,3264,23,101
photo-62.jpg,3,1783,1806,785,856,S3.20,2448,3264,23,71
photo-62.jpg,3,1784,1807,606,677,S0.32,2448,3264,23,71
photo-62.jpg,3,1785,1808,423,495,S3.52,2448,3264,23,72
photo-63.jpg,2,1159,1194,1520,1973,Gloves Low Powder VINYL XLge,2448,3264,35,453
photo-63.jpg,2,1217,1246,1534,1973,Gloves Low Powder VINYL Med,2448,3264,29,439
photo-63.jpg,2,1276,1311,1520,1972,Gloves Low Powder VINYL Large,2448,3264,35,452
photo-63.jpg,2,1335,1370,1347,1973,Docket Book 132 Dup Carbonless 50pg. T/Away,2448,3264,35,626
photo-63.jpg,2,1393,1425,1597,1974,Plastic Cup 08oz/225ml - 50's,2448,3264,32,377
photo-63.jpg,2,1453,1483,1526,1973,Singlet Bags White Medium - 250's,2448,3264,30,447
photo-63.jpg,2,1511,1543,1496,1974,Easybake Baking Paper 30cm x 120m,2448,3264,32,478
photo-63.jpg,2,1569,1594,1751,1974,Pizza Box Brown,2448,3264,25,223
photo-63.jpg,2,1628,1652,1761,1976,Pizza Box Pillars,2448,3264,24,215
photo-63.jpg,2,1686,1718,1691,1977,Laundry Powder 10kg,2448,3264,32,286
photo-63.jpg,1,1156,1178,2192,2206,5,2448,3264,22,14
photo-63.jpg,3,1167,1190,1105,1274,23-GVXLLP,2448,3264,23,169
photo-63.jpg,1,1170,1193,825,914,$22.50,2448,3264,23,89
photo-63.jpg,1,1171,1195,643,713,$2.25,2448,3264,24,70
photo-63.jpg,1,1172,1196,459,545,$24.75,2448,3264,24,86
photo-63.jpg,1,1215,1236,2195,2201,1,2448,3264,21,6
photo-63.jpg,3,1225,1248,1119,1273,23-GVMLP,2448,3264,23,154
photo-63.jpg,1,1227,1252,825,896,$4.50,2448,3264,25,71
photo-63.jpg,1,1230,1254,459,529,$4.95,2448,3264,24,70
photo-63.jpg,1,1229,1253,643,713,$0.45,2448,3264,24,70
photo-63.jpg,3,1274,1295,2196,2201,I,2448,3264,21,5
photo-63.jpg,3,1284,1307,1130,1274,23-GVLLP,2448,3264,23,144
photo-63.jpg,1,1286,1310,825,897,$4.50,2448,3264,24,72
photo-63.jpg,1,1288,1311,643,713,$0.45,2448,3264,23,70
photo-63.jpg,1,1288,1312,459,529,$4.95,2448,3264,24,70
photo-63.jpg,1,1331,1354,2182,2210,10,2448,3264,23,28
photo-63.jpg,3,1342,1365,1141,1270,19-RD132,2448,3264,23,129
photo-63.jpg,1,1345,1369,826,914,$12.00,2448,3264,24,88
photo-63.jpg,1,1346,1370,642,714,$1.20,2448,3264,24,72
photo-63.jpg,1,1348,1371,458,546,$13.20,2448,3264,23,88
photo-63.jpg,1,1390,1413,2197,2203,1,2448,3264,23,6
photo-63.jpg,3,1400,1425,1095,1275,20-PC225PL8,2448,3264,25,180
photo-63.jpg,1,1402,1427,829,899,$2.75,2448,3264,25,70
photo-63.jpg,1,1405,1430,461,531,$3.03,2448,3264,25,70
photo-63.jpg,1,1404,1428,644,716,$0.28,2448,3264,24,72
photo-63.jpg,1,1450,1471,2197,2203,1,2448,3264,21,6
photo-63.jpg,3,1459,1482,1154,1272,12-MCW,2448,3264,23,118
photo-63.jpg,1,1461,1486,829,899,$4.15,2448,3264,25,70
photo-63.jpg,1,1462,1487,645,716,$0.42,2448,3264,25,71
photo-63.jpg,1,1464,1487,461,532,$4.57,2448,3264,23,71
photo-63.jpg,1,1508,1530,2197,2203,1,2448,3264,22,6
photo-63.jpg,3,1517,1539,1162,1272,I4-EB30,2448,3264,22,110
photo-63.jpg,1,1519,1544,829,916,$23.95,2448,3264,25,87
photo-63.jpg,1,1521,1544,644,717,$2.40,2448,3264,23,73
photo-63.jpg,1,1522,1545,461,548,$26.35,2448,3264,23,87
photo-63.jpg,1,1568,1589,2193,2209,4,2448,3264,21,16
photo-63.jpg,3,1575,1598,1118,1277,08-PIZ15PB,2448,3264,23,159
photo-63.jpg,3,1580,1603,460,563,S109.34,2448,3264,23,103
photo-63.jpg,1,1577,1601,828,916,$99.40,2448,3264,24,88
photo-63.jpg,1,1579,1602,644,716,$9.94,2448,3264,23,72
photo-63.jpg,1,1629,1650,2056,2063,1,2448,3264,21,7
photo-63.jpg,3,1634,1658,1108,1278,08-PILLARS,2448,3264,24,170
photo-63.jpg,1,1639,1662,460,548,$52.20,2448,3264,23,88
photo-63.jpg,1,1636,1660,830,917,$47.45,2448,3264,24,87
photo-63.jpg,1,1637,1662,646,717,$4.75,2448,3264,25,71
photo-63.jpg,3,1685,1706,2200,2205,I,2448,3264,21,5
photo-63.jpg,3,1692,1715,1179,1278,01-CLP,2448,3264,23,99
photo-63.jpg,1,1694,1718,830,917,$29.75,2448,3264,24,87
photo-63.jpg,1,1694,1719,645,717,$2.98,2448,3264,25,72
photo-63.jpg,1,1697,1720,461,547,$32.73,2448,3264,23,86
photo-64.jpg,2,1231,1259,1368,1871,Pizza Box Brown 9 Perfect Bite 100’s iz,2448,3264,28,503
photo-64.jpg,2,1286,1319,1446,1871,Gloves Low Powder VINYL XLge,2448,3264,33,425
photo-64.jpg,2,1341,1374,1379,1872,Gloves Low Powder VINYL Large Is',2448,3264,33,493
photo-64.jpg,2,1396,1422,1407,1873,Gloves Low Powder VINYL Med ^,2448,3264,26,466
photo-64.jpg,2,1450,1477,1416,1873,Pizza Box Brown 15 Perfect Bite 50's,2448,3264,27,457
photo-64.jpg,2,1505,1536,1433,1873,Bin Liner 82L HD Handy Pack 100's,2448,3264,31,440
photo-64.jpg,2,1560,1583,1673,1875,Pizza Box Pillars,2448,3264,23,202
photo-64.jpg,2,1614,1641,1420,1875,Genfac Round LID suit 70-150ml 50's,2448,3264,27,455
photo-64.jpg,2,1670,1696,1459,1877,Genfac Round 70ml Container SO's,2448,3264,26,418
photo-64.jpg,2,1726,1756,1614,1878,Tea Towel Regular 12,2448,3264,30,264
photo-64.jpg,1,1241,1265,794,876,$24.20,2448,3264,24,82
photo-64.jpg,1,1243,1267,621,688,$2.42,2448,3264,24,67
photo-64.jpg,3,1239,1262,1032,1166,08-PIZ9PB,2448,3264,23,134
photo-64.jpg,1,1244,1268,449,531,$26.62,2448,3264,24,82
photo-64.jpg,3,1282,1304,2075,2118,—6,2448,3264,22,43
photo-64.jpg,3,1294,1317,1008,1166,23-GVXI J.P,2448,3264,23,158
photo-64.jpg,1,1296,1320,795,876,$27.00,2448,3264,24,81
photo-64.jpg,1,1299,1323,450,531,$29.70,2448,3264,24,81
photo-64.jpg,1,1298,1322,621,688,$2.70,2448,3264,24,67
photo-64.jpg,3,1337,1358,2075,2124,—2,2448,3264,21,49
photo-64.jpg,1,1351,1375,795,861,$9.00,2448,3264,24,66
photo-64.jpg,3,1348,1372,1030,1166,23-GVLLP,2448,3264,24,136
photo-64.jpg,1,1354,1378,450,517,$9.90,2448,3264,24,67
photo-64.jpg,1,1353,1376,622,689,$0.90,2448,3264,23,67
photo-64.jpg,3,1392,1416,2081,2127,~^1,2448,3264,24,46
photo-64.jpg,3,1403,1426,1022,1167,23-GVMLP,2448,3264,23,145
photo-64.jpg,1,1406,1429,796,862,$4.50,2448,3264,23,66
photo-64.jpg,1,1408,1431,624,690,$0.45,2448,3264,23,66
photo-64.jpg,1,1409,1433,452,518,$4.95,2448,3264,24,66
photo-64.jpg,3,1447,1467,2078,2126,-.4,2448,3264,20,48
photo-64.jpg,3,1458,1481,1018,1168,08-PIZ15PB,2448,3264,23,150
photo-64.jpg,1,1460,1485,796,877,$99.40,2448,3264,25,81
photo-64.jpg,1,1462,1486,624,690,$9.94,2448,3264,24,66
photo-64.jpg,1,1463,1487,452,548,$109.34,2448,3264,24,96
photo-64.jpg,1,1515,1539,796,878,$18.20,2448,3264,24,82
photo-64.jpg,3,1513,1535,967,1164,12-LDBIN82HP,2448,3264,22,197
photo-64.jpg,1,1517,1540,624,691,$1.82,2448,3264,23,67
photo-64.jpg,1,1518,1542,451,534,$20.02,2448,3264,24,83
photo-64.jpg,1,1570,1593,797,879,$43.80,2448,3264,23,82
photo-64.jpg,1,1623,1648,797,864,$2.40,2448,3264,25,67
photo-64.jpg,3,1568,1589,1010,1169,08-PILLARS,2448,3264,21,159
photo-64.jpg,1,1572,1595,626,692,$4.38,2448,3264,23,66
photo-64.jpg,1,1573,1596,454,535,$48.18,2448,3264,23,81
photo-64.jpg,3,1622,1646,953,1169,03-GRLID70-150,2448,3264,24,216
photo-64.jpg,1,1625,1649,624,691,$0.24,2448,3264,24,67
photo-64.jpg,1,1627,1651,452,519,$2.64,2448,3264,24,67
photo-64.jpg,1,1679,1704,796,864,$3.50,2448,3264,25,68
photo-64.jpg,1,1683,1707,452,518,$3.85,2448,3264,24,66
photo-64.jpg,3,1678,1701,1057,1169,03-GR70,2448,3264,23,112
photo-64.jpg,1,1681,1704,625,691,$0.35,2448,3264,23,66
photo-64.jpg,1,1737,1761,451,533,$13.20,2448,3264,24,82
photo-64.jpg,3,1733,1754,1075,1170,02-TTR,2448,3264,21,95
photo-64.jpg,1,1735,1759,797,879,$12.00,2448,3264,24,82
photo-64.jpg,1,1736,1760,624,692,$1.20,2448,3264,24,68
photo-65.jpg,2,1265,1295,1455,1909,Gloves Low Powder VINYL XLge,2448,3264,30,454
photo-65.jpg,2,1324,1348,1468,1909,Gloves Low Powder VINYL Med,2448,3264,24,441
photo-65.jpg,2,1383,1414,1454,1909,Gloves Low Powder VINYL Large,2448,3264,31,455
photo-65.jpg,2,1441,1472,1280,1908,Docket Book 132 Dup Carbonless 50pg. T/Away,2448,3264,31,628
photo-65.jpg,2,1500,1524,1419,1908,Pizza Box Brown 9 Perfect Bite 100's,2448,3264,24,489
photo-65.jpg,2,1559,1583,1420,1907,Pizza Box Brown 15 Perfect Bite 50's,2448,3264,24,487
photo-65.jpg,2,1617,1642,1526,1907,Brilliant Auto Dish Wash 20L,2448,3264,25,381
photo-65.jpg,1,1264,1286,2129,2143,3,2448,3264,22,14
photo-65.jpg,1,1266,1291,571,641,$1.35,2448,3264,25,70
photo-65.jpg,1,1266,1291,387,472,$14.85,2448,3264,25,85
photo-65.jpg,1,1266,1291,756,843,$13.50,2448,3264,25,87
photo-65.jpg,3,1266,1289,1038,1207,23-GVXLLP,2448,3264,23,169
photo-65.jpg,1,1324,1346,2132,2140,1,2448,3264,22,8
photo-65.jpg,1,1324,1350,572,642,$0.45,2448,3264,26,70
photo-65.jpg,1,1325,1349,387,457,$4.95,2448,3264,24,70
photo-65.jpg,3,1325,1348,1052,1207,23-GVMLP,2448,3264,23,155
photo-65.jpg,1,1324,1349,757,828,$4.50,2448,3264,25,71
photo-65.jpg,1,1382,1404,2128,2142,3,2448,3264,22,14
photo-65.jpg,1,1383,1409,757,844,$13.50,2448,3264,26,87
photo-65.jpg,1,1383,1409,572,642,$1.35,2448,3264,26,70
photo-65.jpg,1,1383,1409,387,471,$14.85,2448,3264,26,84
photo-65.jpg,3,1384,1407,1062,1207,23-GVLLP,2448,3264,23,145
photo-65.jpg,1,1441,1464,2128,2143,6,2448,3264,23,15
photo-65.jpg,1,1443,1468,571,642,$0.72,2448,3264,25,71
photo-65.jpg,1,1443,1467,386,456,$7.92,2448,3264,24,70
photo-65.jpg,3,1443,1466,1072,1204,19-RD132,2448,3264,23,132
photo-65.jpg,1,1442,1467,757,829,$7.20,2448,3264,25,72
photo-65.jpg,1,1501,1522,2131,2138,1,2448,3264,21,7
photo-65.jpg,1,1501,1526,572,643,$2.42,2448,3264,25,71
photo-65.jpg,1,1501,1526,386,472,$26.62,2448,3264,25,86
photo-65.jpg,1,1500,1526,758,845,$24.20,2448,3264,26,87
photo-65.jpg,3,1501,1524,1063,1207,08-PIZ9PB,2448,3264,23,144
photo-65.jpg,1,1559,1581,2127,2143,4,2448,3264,22,16
photo-65.jpg,1,1560,1585,386,489,$109.34,2448,3264,25,103
photo-65.jpg,1,1559,1585,758,845,$99.40,2448,3264,26,87
photo-65.jpg,1,1559,1585,571,643,$9.94,2448,3264,26,72
photo-65.jpg,3,1560,1582,1048,1207,08-PIZ15PB,2448,3264,22,159
photo-65.jpg,1,1618,1643,386,473,$84.70,2448,3264,25,87
photo-65.jpg,1,1618,1641,1988,1997,1,2448,3264,23,9
photo-65.jpg,1,1618,1645,570,643,$7.70,2448,3264,27,73
photo-65.jpg,3,1618,1642,1091,1208,01-CB20,2448,3264,24,117
photo-65.jpg,1,1617,1644,758,845,$77.00,2448,3264,27,87
photo-66.jpg,2,1180,1213,1469,1899,Gloves Low Powder VINYL XLge,2448,3264,33,430
photo-66.jpg,2,1235,1262,1483,1898,Gloves Low Powder VINYL Med,2448,3264,27,415
photo-66.jpg,2,1290,1315,1697,1899,Pizza Box Pillars,2448,3264,25,202
photo-66.jpg,2,1346,1379,1473,1901,Gloves Low Powder VINYL Large,2448,3264,33,428
photo-66.jpg,2,1400,1437,1308,1902,Docket Book 132 Dup Carbonless 50pg. T/Away,2448,3264,37,594
photo-66.jpg,2,1455,1484,1441,1903,Pizza Box Brown 15 Perfect Bite 50's,2448,3264,29,462
photo-66.jpg,2,1511,1543,1593,1906,Green Clean Detergent 5L,2448,3264,32,313
photo-66.jpg,1,1196,1220,456,540,$24.75,2448,3264,24,84
photo-66.jpg,1,1192,1215,808,894,$22.50,2448,3264,23,86
photo-66.jpg,3,1188,1211,1075,1237,23-GVXLLP,2448,3264,23,162
photo-66.jpg,1,1177,1199,2098,2115,5,2448,3264,22,17
photo-66.jpg,1,1193,1218,633,702,$2.25,2448,3264,25,69
photo-66.jpg,1,1252,1276,456,526,$4.95,2448,3264,24,70
photo-66.jpg,3,1242,1267,1089,1238,23-GVMLP,2448,3264,25,149
photo-66.jpg,1,1246,1272,809,879,$4.50,2448,3264,26,70
photo-66.jpg,1,1249,1275,633,703,$0.45,2448,3264,26,70
photo-66.jpg,1,1233,1254,2104,2112,1,2448,3264,21,8
photo-66.jpg,1,1307,1332,455,541,$52.20,2448,3264,25,86
photo-66.jpg,3,1298,1323,1076,1239,08-PILLARS,2448,3264,25,163
photo-66.jpg,1,1303,1327,811,894,$47.45,2448,3264,24,83
photo-66.jpg,1,1290,1312,1973,1982,1,2448,3264,22,9
photo-66.jpg,1,1305,1330,634,704,$4.75,2448,3264,25,70
photo-66.jpg,1,1363,1387,456,527,$9.90,2448,3264,24,71
photo-66.jpg,1,1343,1365,2103,2119,2,2448,3264,22,16
photo-66.jpg,3,1353,1378,1101,1240,23-GVLLP,2448,3264,25,139
photo-66.jpg,1,1358,1383,811,880,$9.00,2448,3264,25,69
photo-66.jpg,1,1360,1386,634,704,$0.90,2448,3264,26,70
photo-66.jpg,1,1418,1443,457,528,$7.92,2448,3264,25,71
photo-66.jpg,1,1398,1420,2104,2121,6,2448,3264,22,17
photo-66.jpg,3,1409,1433,1111,1237,19-RDI32,2448,3264,24,126
photo-66.jpg,1,1412,1438,810,881,$7.20,2448,3264,26,71
photo-66.jpg,1,1416,1441,634,705,$0.72,2448,3264,25,71
photo-66.jpg,1,1472,1498,457,558,$109.34,2448,3264,26,101
photo-66.jpg,1,1454,1476,2107,2123,4,2448,3264,22,16
photo-66.jpg,1,1468,1494,811,897,$99.40,2448,3264,26,86
photo-66.jpg,3,1464,1490,1088,1242,08-PIZ15PB,2448,3264,26,154
photo-66.jpg,1,1471,1496,635,705,$9.94,2448,3264,25,70
photo-66.jpg,1,1529,1555,457,543,$11.06,2448,3264,26,86
photo-66.jpg,1,1510,1531,2112,2121,1,2448,3264,21,9
photo-66.jpg,3,1520,1544,1124,1243,01-CGC5,2448,3264,24,119
photo-66.jpg,1,1525,1549,814,897,$10.05,2448,3264,24,83
photo-66.jpg,1,1527,1553,641,705,$1.01,2448,3264,26,64
photo-67.jpg,2,1217,1242,1519,1955,Gloves Low Powder VINYL Med,2448,3264,25,436
photo-67.jpg,2,1275,1305,1506,1956,Gloves Low Powder VINYL Large,2448,3264,30,450
photo-67.jpg,2,1333,1362,1504,1955,Gloves Low Powder VINYL XLge,2448,3264,29,451
photo-67.jpg,2,1391,1422,1332,1954,Docket Book 132 Dup Carbonless 50pg. T/Away,2448,3264,31,622
photo-67.jpg,2,1449,1479,1488,1955,Bin Liner 82L HD Handy Pack 100's,2448,3264,30,467
photo-67.jpg,2,1507,1540,1510,1955,Singlet Bags White Medium - 250's,2448,3264,33,445
photo-67.jpg,2,1565,1591,1471,1956,Pizza Box Brown 15 Perfect Bite 50's,2448,3264,26,485
photo-67.jpg,2,1624,1651,1508,1957,Food Bowl 20oz Dome Lid Mar 50,2448,3264,27,449
photo-67.jpg,2,1684,1716,1604,1956,Wipes H.D. Roll BLUE CA,2448,3264,32,352
photo-67.jpg,1,1214,1238,446,517,$4.95,2448,3264,24,71
photo-67.jpg,1,1217,1241,814,885,$4.50,2448,3264,24,71
photo-67.jpg,1,1215,1240,631,701,$0.45,2448,3264,25,70
photo-67.jpg,3,1217,1241,1106,1260,23-GVMLP,2448,3264,24,154
photo-67.jpg,1,1274,1299,814,885,$4.50,2448,3264,25,71
photo-67.jpg,1,1273,1298,631,701,$0.45,2448,3264,25,70
photo-67.jpg,1,1272,1296,447,517,$4.95,2448,3264,24,70
photo-67.jpg,3,1275,1299,1116,1260,23-GVLLP,2448,3264,24,144
photo-67.jpg,3,1336,1358,2172,2238,— 5,2448,3264,22,66
photo-67.jpg,1,1332,1357,814,901,$22.50,2448,3264,25,87
photo-67.jpg,1,1331,1355,631,701,$2.25,2448,3264,24,70
photo-67.jpg,3,1333,1356,1092,1260,23-GVXLLP,2448,3264,23,168
photo-67.jpg,1,1330,1353,446,533,$24.75,2448,3264,23,87
photo-67.jpg,1,1390,1415,813,884,$6.00,2448,3264,25,71
photo-67.jpg,3,1391,1415,1126,1255,19-RD132,2448,3264,24,129
photo-67.jpg,1,1389,1413,628,700,$0.60,2448,3264,24,72
photo-67.jpg,1,1388,1412,444,516,$6.60,2448,3264,24,72
photo-67.jpg,1,1448,1473,813,900,$18.20,2448,3264,25,87
photo-67.jpg,1,1446,1471,629,700,$1.82,2448,3264,25,71
photo-67.jpg,1,1446,1470,444,531,$20.02,2448,3264,24,87
photo-67.jpg,3,1449,1472,1046,1255,12-LDBIN82HP,2448,3264,23,209
photo-67.jpg,1,1506,1530,814,883,$4.15,2448,3264,24,69
photo-67.jpg,1,1504,1528,445,515,$4.57,2448,3264,24,70
photo-67.jpg,3,1508,1530,1138,1255,12-MCW,2448,3264,22,117
photo-67.jpg,1,1505,1529,629,700,$0.42,2448,3264,24,71
photo-67.jpg,3,1570,1592,2174,2241,_ 5,2448,3264,22,67
photo-67.jpg,1,1564,1589,814,916,$124.25,2448,3264,25,102
photo-67.jpg,3,1566,1588,1101,1260,08-PIZ15PB,2448,3264,22,159
photo-67.jpg,1,1563,1588,629,715,$12.43,2448,3264,25,86
photo-67.jpg,1,1562,1586,444,547,$136.68,2448,3264,24,103
photo-67.jpg,1,1623,1648,813,900,$16.55,2448,3264,25,87
photo-67.jpg,1,1621,1648,627,700,$1.66,2448,3264,27,73
photo-67.jpg,1,1621,1645,446,530,$18.21,2448,3264,24,84
photo-67.jpg,3,1624,1648,1031,1261,04-6620DLMAR.,2448,3264,24,230
photo-67.jpg,3,1690,1710,2179,2184,I,2448,3264,20,5
photo-67.jpg,1,1681,1707,813,899,$19.05,2448,3264,26,86
photo-67.jpg,3,1683,1707,1037,1260,02-CAWIPEBlue,2448,3264,24,223
photo-67.jpg,1,1681,1706,632,698,$1.91,2448,3264,25,66
photo-67.jpg,1,1679,1704,442,529,$20.96,2448,3264,25,87
photo-68.jpg,2,1243,1281,1251,1880,Docket Book 132 Dup Carbonless 50pg. T/Away,2448,3264,38,629
photo-68.jpg,2,1305,1338,1425,1878,Gloves Low Powder VINYL XLge,2448,3264,33,453
photo-68.jpg,2,1363,1397,1425,1877,Gloves Low Powder VINYL Large,2448,3264,34,452
photo-68.jpg,2,1424,1460,1501,1878,Plastic Cop 08oz/225ml - 50’s,2448,3264,36,377
photo-68.jpg,2,1481,1513,1387,1876,Pizza Box Brown 15* Perfect Bite 50's,2448,3264,32,489
photo-68.jpg,2,1542,1573,1532,1874,Stainless Steel Scourer 50g,2448,3264,31,342
photo-68.jpg,2,1603,1629,1610,1872,Green Scourer Small,2448,3264,26,262
photo-68.jpg,1,1229,1258,717,808,$14.40,2448,3264,29,91
photo-68.jpg,1,1261,1285,2082,2111,12,2448,3264,24,29
photo-68.jpg,3,1236,1262,986,1119,I9-RDI32,2448,3264,26,133
photo-68.jpg,1,1225,1253,526,602,$1.44,2448,3264,28,76
photo-68.jpg,1,1218,1247,331,425,$15.84,2448,3264,29,94
photo-68.jpg,1,1320,1343,2091,2106,5,2448,3264,23,15
photo-68.jpg,3,1293,1323,950,1123,23-GVXLLP,2448,3264,30,173
photo-68.jpg,1,1289,1317,717,808,$22.50,2448,3264,28,91
photo-68.jpg,1,1284,1311,527,601,$225,2448,3264,27,74
photo-68.jpg,1,1343,1371,526,600,$1.35,2448,3264,28,74
photo-68.jpg,1,1404,1432,525,600,$0.28,2448,3264,28,75
photo-68.jpg,1,1278,1307,333,426,$24.75,2448,3264,29,93
photo-68.jpg,1,1376,1401,2089,2104,3,2448,3264,25,15
photo-68.jpg,3,1353,1382,973,1121,23-GVLLP,2448,3264,29,148
photo-68.jpg,1,1349,1377,716,807,$13.50,2448,3264,28,91
photo-68.jpg,1,1408,1437,716,791,$2.75,2448,3264,29,75
photo-68.jpg,1,1338,1367,331,425,$14.85,2448,3264,29,94
photo-68.jpg,1,1398,1427,330,408,$3.03,2448,3264,29,78
photo-68.jpg,1,1436,1460,2090,2102,1,2448,3264,24,12
photo-68.jpg,3,1413,1440,934,1121,20-PC225PL8,2448,3264,27,187
photo-68.jpg,1,1494,1517,2086,2104,4,2448,3264,23,18
photo-68.jpg,3,1474,1498,956,1120,08-PIZI5PH,2448,3264,24,164
photo-68.jpg,1,1467,1496,713,806,$99.40,2448,3264,29,93
photo-68.jpg,1,1527,1554,711,787,$4.40,2448,3264,27,76
photo-68.jpg,1,1585,1612,710,786,$4.00,2448,3264,27,76
photo-68.jpg,1,1464,1492,523,600,$9.94,2448,3264,28,77
photo-68.jpg,1,1460,1488,328,440,$109.34,2448,3264,28,112
photo-68.jpg,1,1519,1546,327,405,$4.84,2448,3264,27,78
photo-68.jpg,1,1579,1605,325,404,$4.40,2448,3264,26,79
photo-68.jpg,1,1552,1576,2085,2101,2,2448,3264,24,16
photo-68.jpg,3,1533,1558,1020,1119,02-SSS,2448,3264,25,99
photo-68.jpg,1,1523,1550,522,598,$0.44,2448,3264,27,76
photo-68.jpg,1,1610,1634,2082,2100,5,2448,3264,24,18
photo-68.jpg,3,1591,1616,1014,1118,02-GSS,2448,3264,25,104
photo-68.jpg,1,1582,1609,520,597,$0.40,2448,3264,27,77
photo-69.jpg,2,1181,1215,1746,1997,Spray Bottle 500ml,2448,3264,34,251
photo-69.jpg,2,1242,1275,1821,1997,Spray Nozzle,2448,3264,33,176
photo-69.jpg,2,1301,1335,1790,1997,Spray Bottle 1L,2448,3264,34,207
photo-69.jpg,2,1360,1390,1530,1996,Gloves Low Powder VINYL Large,2448,3264,30,466
photo-69.jpg,2,1419,1448,1544,1995,Gloves Low Powder VINYL Med,2448,3264,29,451
photo-69.jpg,2,1478,1511,1349,1996,Docket Book 132 Dup Carbonless 50pg. T/Away,2448,3264,33,647
photo-69.jpg,2,1539,1570,1529,1995,Gloves Low Powder VINYL XLge,2448,3264,31,466
photo-69.jpg,2,1599,1629,1491,1994,Pizza Box Brown 15 Perfect Bite 50's,2448,3264,30,503
photo-69.jpg,1,1186,1210,2221,2237,2,2448,3264,24,16
photo-69.jpg,1,1169,1195,820,892,$4.10,2448,3264,26,72
photo-69.jpg,1,1164,1189,446,515,$4.51,2448,3264,25,69
photo-69.jpg,3,1173,1198,1060,1224,24-SB500ml,2448,3264,25,164
photo-69.jpg,1,1167,1194,636,705,$0.41,2448,3264,27,69
photo-69.jpg,1,1248,1270,2220,2237,4,2448,3264,22,17
photo-69.jpg,1,1223,1249,440,514,$6.60,2448,3264,26,74
photo-69.jpg,3,1233,1258,1093,1223,24-SNOZ,2448,3264,25,130
photo-69.jpg,1,1229,1254,819,891,$6.00,2448,3264,25,72
photo-69.jpg,1,1227,1254,630,704,$0.60,2448,3264,27,74
photo-69.jpg,1,1308,1330,2221,2236,2,2448,3264,22,15
photo-69.jpg,1,1289,1314,817,890,$5.40,2448,3264,25,73
photo-69.jpg,3,1293,1318,1103,1222,24-SB1L,2448,3264,25,119
photo-69.jpg,1,1283,1310,439,512,$5.94,2448,3264,27,73
photo-69.jpg,1,1287,1313,629,702,$0.54,2448,3264,26,73
photo-69.jpg,1,1367,1390,2221,2236,2,2448,3264,23,15
photo-69.jpg,1,1348,1375,816,888,$9.00,2448,3264,27,72
photo-69.jpg,3,1353,1378,1073,1221,23-GVLLP,2448,3264,25,148
photo-69.jpg,1,1343,1369,436,510,$9.90,2448,3264,26,74
photo-69.jpg,1,1347,1373,627,701,$0.90,2448,3264,26,74
photo-69.jpg,1,1428,1450,2225,2231,1,2448,3264,22,6
photo-69.jpg,1,1409,1434,814,888,$4.50,2448,3264,25,74
photo-69.jpg,3,1413,1438,1061,1221,23-GVMLP,2448,3264,25,160
photo-69.jpg,1,1406,1433,626,700,$0.45,2448,3264,27,74
photo-69.jpg,1,1403,1428,436,510,$4.95,2448,3264,25,74
photo-69.jpg,1,1488,1511,2219,2236,6,2448,3264,23,17
photo-69.jpg,1,1468,1494,812,886,$7.20,2448,3264,26,74
photo-69.jpg,3,1472,1498,1081,1217,19-RD132,2448,3264,26,136
photo-69.jpg,1,1465,1493,624,698,$0.72,2448,3264,28,74
photo-69.jpg,1,1463,1488,434,508,$7.92,2448,3264,25,74
photo-69.jpg,1,1549,1572,2219,2235,6,2448,3264,23,16
photo-69.jpg,1,1527,1554,812,902,$27.00,2448,3264,27,90
photo-69.jpg,3,1532,1558,1045,1219,23-GVXLLP,2448,3264,26,174
photo-69.jpg,1,1526,1552,623,697,$2.70,2448,3264,26,74
photo-69.jpg,1,1523,1548,433,523,$29.70,2448,3264,25,90
photo-69.jpg,1,1609,1632,2220,2235,5,2448,3264,23,15
photo-69.jpg,1,1588,1615,812,916,$124.25,2448,3264,27,104
photo-69.jpg,1,1586,1612,623,712,$12.43,2448,3264,26,89
photo-69.jpg,1,1583,1609,432,538,$136.68,2448,3264,26,106
photo-69.jpg,3,1594,1619,1053,1218,08-PIZ15PB,2448,3264,25,165
photo-70.jpg,2,1160,1189,1543,1838,Pomace Olive Oil 4lt,3264,2448,29,295
photo-70.jpg,2,1208,1242,1407,1840,Tomato Pulp BULK #38110kg,3264,2448,34,433
photo-70.jpg,2,1257,1290,1378,1838,Fire Roast Pepper STRIP 4.2kg,3264,2448,33,460
photo-70.jpg,2,1309,1337,1623,1838,BBQ Sauce 3lt,3264,2448,28,215
photo-70.jpg,2,1356,1391,1387,1837,Pineapple Pizza Cut Tidbit A10,3264,2448,35,450
photo-70.jpg,2,1406,1436,1429,1837,BROWN Pizza Box 100x12,3264,2448,30,408
photo-70.jpg,2,1455,1486,1382,1838,Pizza InsertIO Cardboard 100s,3264,2448,31,456
photo-70.jpg,2,1505,1539,1401,1837,Mozzarella Traditional [6x2kg],3264,2448,34,436
photo-70.jpg,2,1556,1586,1396,1837,Cream Thickened Caterers 5lt,3264,2448,30,441
photo-70.jpg,2,1608,1639,1492,1838,Semi Dried Tomato 5kg,3264,2448,31,346
photo-70.jpg,2,1656,1687,1393,1837,Gnocchi Grooves Potato 1 kg,3264,2448,31,444
photo-70.jpg,2,1706,1737,1375,1835,Prawn Meat 31/40 GARLIC 1kg,3264,2448,31,460
photo-70.jpg,1,1133,1160,245,327,18.60,3264,2448,27,82
photo-70.jpg,1,1182,1210,244,327,33.80,3264,2448,28,83
photo-70.jpg,1,1232,1259,242,328,41.70,3264,2448,27,86
photo-70.jpg,1,1145,1171,724,786,0.00,3264,2448,26,62
photo-70.jpg,3,1151,1181,898,1064,1^ 18.60,3264,2448,30,166
photo-70.jpg,3,1199,1230,896,1066,2 s' 16.90,3264,2448,31,170
photo-70.jpg,3,1248,1278,895,1065,3 ^ 13.90,3264,2448,30,170
photo-70.jpg,3,1162,1187,1952,2045,ANTO,3264,2448,25,93
photo-70.jpg,3,1210,1236,1929,2042,PRONF,3264,2448,26,113
photo-70.jpg,3,1259,1285,1931,2042,NESTO,3264,2448,26,111
photo-70.jpg,3,1308,1335,1931,2044,SUNSH,3264,2448,27,113
photo-70.jpg,3,1358,1384,1931,2043,GBELO,3264,2448,26,112
photo-70.jpg,3,1408,1433,1934,2043,PERFE,3264,2448,25,109
photo-70.jpg,3,1458,1484,1948,2043,FIRST,3264,2448,26,95
photo-70.jpg,3,1508,1534,1938,2045,ALESS,3264,2448,26,107
photo-70.jpg,3,1558,1584,1945,2043,D/FAR,3264,2448,26,98
photo-70.jpg,3,1608,1634,1933,2043,GLOBL,3264,2448,26,110
photo-70.jpg,1,1195,1220,723,785,0.00,3264,2448,25,62
photo-70.jpg,1,1244,1270,721,785,0.00,3264,2448,26,64
photo-70.jpg,1,1294,1319,721,784,0.00,3264,2448,25,63
photo-70.jpg,1,1298,1322,895,957,8.15,3264,2448,24,62
photo-70.jpg,1,1282,1309,242,306,8.15,3264,2448,27,64
photo-70.jpg,1,1300,1324,1052,1062,1,3264,2448,24,10
photo-70.jpg,1,1342,1369,720,782,0.00,3264,2448,27,62
photo-70.jpg,1,1332,1359,240,324,63.00,3264,2448,27,84
photo-70.jpg,1,1381,1409,239,322,99.00,3264,2448,28,83
photo-70.jpg,1,1432,1460,238,322,51.59,3264,2448,28,84
photo-70.jpg,1,1482,1510,236,340,679.00,3264,2448,28,104
photo-70.jpg,1,1532,1560,235,320,67.60,3264,2448,28,85
photo-70.jpg,1,1583,1610,233,318,43.75,3264,2448,27,85
photo-70.jpg,1,1635,1662,231,315,27.80,3264,2448,27,84
photo-70.jpg,1,1685,1712,233,314,79.01,3264,2448,27,81
photo-70.jpg,1,1347,1373,894,956,5.25,3264,2448,26,62
photo-70.jpg,3,1349,1381,1013,1079,12^,3264,2448,32,66
photo-70.jpg,1,1388,1414,501,565,9.00,3264,2448,26,64
photo-70.jpg,1,1392,1419,718,782,0.00,3264,2448,27,64
photo-70.jpg,3,1397,1427,892,1063,3 ^ 30.00,3264,2448,30,171
photo-70.jpg,1,1439,1464,500,564,4.69,3264,2448,25,64
photo-70.jpg,1,1448,1471,892,955,9.38,3264,2448,23,63
photo-70.jpg,1,1443,1469,718,781,0.00,3264,2448,26,63
photo-70.jpg,3,1449,1486,1000,1062,5^,3264,2448,37,62
photo-70.jpg,3,1498,1525,1009,1060,7^,3264,2448,27,51
photo-70.jpg,1,1496,1524,890,973,97.00,3264,2448,28,83
photo-70.jpg,3,1549,1576,1001,1061,4 s,3264,2448,27,60
photo-70.jpg,1,1547,1573,889,970,16.90,3264,2448,26,81
photo-70.jpg,3,1597,1626,889,1057,1/ 43.75,3264,2448,29,168
photo-70.jpg,1,1650,1676,1041,1058,4,3264,2448,26,17
photo-70.jpg,1,1648,1673,888,951,6.95,3264,2448,25,63
photo-70.jpg,1,1700,1726,1040,1058,4,3264,2448,26,18
photo-70.jpg,3,1683,1724,886,1007,^ 19.75,3264,2448,41,121
photo-70.jpg,1,1493,1519,716,780,0.00,3264,2448,26,64
photo-70.jpg,1,1543,1569,716,779,0.00,3264,2448,26,63
photo-70.jpg,1,1594,1619,715,778,0.00,3264,2448,25,63
photo-70.jpg,1,1644,1670,713,776,0.00,3264,2448,26,63
photo-70.jpg,3,1659,1684,1983,2044,ZINI,3264,2448,25,61
photo-70.jpg,1,1694,1720,711,775,0.00,3264,2448,26,64
photo-70.jpg,3,1708,1734,1933,2043,NEPTU,3264,2448,26,110
photo-70.jpg,1,1744,1771,710,773,0.00,3264,2448,27,63
photo-71.jpg,2,1081,1123,1407,1926,Tomatoes Crushed BULKIOkgSUB,3264,2448,42,519
photo-71.jpg,2,1134,1172,1531,1923,Mushroom Forest Mix 500g,3264,2448,38,392
photo-71.jpg,2,1186,1226,1628,1925,Vinegar Balsamic 5lt,3264,2448,40,297
photo-71.jpg,2,1234,1274,1558,1924,Yeast Dry ANGEST 500g,3264,2448,40,366
photo-71.jpg,2,1279,1323,1475,1920,Pineapple Pizza Cut Tidbit A10,3264,2448,44,445
photo-71.jpg,2,1331,1369,1516,1919,BROWN Pizza Box 100x12,3264,2448,38,403
photo-71.jpg,2,1379,1419,1468,1917,Pizza InsertIO11 CardboardlOOs,3264,2448,40,449
photo-71.jpg,2,1429,1468,1485,1917,Mozzarella Traditional [6x2kg],3264,2448,39,432
photo-71.jpg,2,1483,1518,1636,1916,Cream Sour Lite 2lt,3264,2448,35,280
photo-71.jpg,2,1528,1566,1479,1915,Cream Thickened Caterers 5lt,3264,2448,38,436
photo-71.jpg,2,1581,1615,1573,1914,Semi Dried Tomato 5kg,3264,2448,34,341
photo-71.jpg,2,1627,1665,1474,1913,Gnocchi Grooves Potato 1kg,3264,2448,38,439
photo-71.jpg,3,1098,1123,2027,2127,FIAMA,3264,2448,25,100
photo-71.jpg,3,1146,1173,2020,2128,WILDM,3264,2448,27,108
photo-71.jpg,3,1195,1221,2013,2127,TOSCH,3264,2448,26,114
photo-71.jpg,3,1244,1271,2012,2127,ANGES,3264,2448,27,115
photo-71.jpg,3,1293,1321,2011,2124,GBELO,3264,2448,28,113
photo-71.jpg,3,1343,1370,2015,2122,PERFE,3264,2448,27,107
photo-71.jpg,3,1392,1419,2026,2120,FIRST,3264,2448,27,94
photo-71.jpg,3,1442,1469,2015,2122,ALESS,3264,2448,27,107
photo-71.jpg,3,1491,1518,2022,2118,D/FAR,3264,2448,27,96
photo-71.jpg,3,1540,1568,2020,2117,D/FAR,3264,2448,28,97
photo-71.jpg,3,1589,1616,2008,2118,GLOBL,3264,2448,27,110
photo-71.jpg,1,1073,1098,1144,1161,2,3264,2448,25,17
photo-71.jpg,1,1067,1095,993,1072,18.45,3264,2448,28,79
photo-71.jpg,1,1123,1147,1146,1158,1,3264,2448,24,12
photo-71.jpg,1,1116,1144,991,1073,41.20,3264,2448,28,82
photo-71.jpg,1,1172,1196,1146,1156,1,3264,2448,24,10
photo-71.jpg,1,1166,1193,991,1069,17.54,3264,2448,27,78
photo-71.jpg,1,1093,1122,349,433,41.20,3264,2448,29,84
photo-71.jpg,1,1143,1171,347,428,17.54,3264,2448,28,81
photo-71.jpg,1,1192,1221,347,427,13.32,3264,2448,29,80
photo-71.jpg,1,1241,1271,344,428,31.50,3264,2448,30,84
photo-71.jpg,1,1291,1320,343,426,66.00,3264,2448,29,83
photo-71.jpg,1,1341,1371,341,426,41.27,3264,2448,30,85
photo-71.jpg,1,1391,1421,340,442,485.00,3264,2448,30,102
photo-71.jpg,1,1442,1469,337,419,12.16,3264,2448,27,82
photo-71.jpg,1,1492,1519,336,419,50.70,3264,2448,27,83
photo-71.jpg,1,1541,1568,334,418,43.75,3264,2448,27,84
photo-71.jpg,1,1590,1619,332,413,13.90,3264,2448,29,81
photo-71.jpg,1,1062,1089,822,883,0.00,3264,2448,27,61
photo-71.jpg,1,1111,1138,820,883,0.00,3264,2448,27,63
photo-71.jpg,1,1161,1187,819,882,0.00,3264,2448,26,63
photo-71.jpg,1,1220,1245,1140,1158,4,3264,2448,25,18
photo-71.jpg,1,1215,1241,989,1051,3.33,3264,2448,26,62
photo-71.jpg,1,1210,1236,817,880,0.00,3264,2448,26,63
photo-71.jpg,1,1269,1295,1140,1157,6,3264,2448,26,17
photo-71.jpg,1,1264,1291,988,1050,5.25,3264,2448,27,62
photo-71.jpg,1,1259,1286,816,879,0.00,3264,2448,27,63
photo-71.jpg,1,1301,1329,601,663,6.00,3264,2448,28,62
photo-71.jpg,1,1318,1344,1138,1155,2,3264,2448,26,17
photo-71.jpg,1,1313,1342,986,1067,30.00,3264,2448,29,81
photo-71.jpg,1,1309,1335,815,877,0.00,3264,2448,26,62
photo-71.jpg,1,1351,1378,598,661,3.75,3264,2448,27,63
photo-71.jpg,1,1369,1394,1137,1154,4,3264,2448,25,17
photo-71.jpg,1,1364,1391,985,1048,9.38,3264,2448,27,63
photo-71.jpg,1,1359,1386,813,876,0.00,3264,2448,27,63
photo-71.jpg,1,1418,1444,1134,1151,5,3264,2448,26,17
photo-71.jpg,1,1413,1442,983,1064,97.00,3264,2448,29,81
photo-71.jpg,1,1468,1494,1137,1149,1,3264,2448,26,12
photo-71.jpg,1,1463,1491,982,1061,12.16,3264,2448,28,79
photo-71.jpg,1,1517,1543,1132,1148,3,3264,2448,26,16
photo-71.jpg,1,1512,1540,981,1059,16.90,3264,2448,28,78
photo-71.jpg,1,1567,1592,1134,1146,1,3264,2448,25,12
photo-71.jpg,1,1562,1589,979,1061,43.75,3264,2448,27,82
photo-71.jpg,1,1616,1643,1130,1146,2,3264,2448,27,16
photo-71.jpg,1,1611,1639,978,1040,6.95,3264,2448,28,62
photo-71.jpg,1,1408,1435,812,875,0.00,3264,2448,27,63
photo-71.jpg,1,1458,1485,810,873,0.00,3264,2448,27,63
photo-71.jpg,1,1507,1534,809,871,0.00,3264,2448,27,62
photo-71.jpg,1,1557,1583,807,870,0.00,3264,2448,26,63
photo-71.jpg,3,1640,1667,2056,2117,ZINI,3264,2448,27,61
photo-71.jpg,1,1606,1634,806,869,0.00,3264,2448,28,63
photo-71.jpg,1,1657,1683,804,867,0.00,3264,2448,26,63
photo-72.jpg,2,1197,1230,1482,1941,Fire Roast Pepper STRIP 4.2kg,3264,2448,33,459
photo-72.jpg,2,1247,1280,1507,1941,Mozzarella Traditional [6x2kg],3264,2448,33,434
photo-72.jpg,2,1296,1323,1504,1942,Cream Thickened Caterers 5lt,3264,2448,27,438
photo-72.jpg,2,1345,1378,1484,1941,Prawn Meat 31/40 GARLIC 1kg,3264,2448,33,457
photo-72.jpg,3,1189,1217,2036,2150,NESTO,3264,2448,28,114
photo-72.jpg,3,1239,1266,2044,2152,ALESS,3264,2448,27,108
photo-72.jpg,3,1289,1315,2051,2149,D/FAR,3264,2448,26,98
photo-72.jpg,3,1339,1365,2039,2149,NEPTU,3264,2448,26,110
photo-72.jpg,1,1198,1223,1000,1080,13.90,3264,2448,25,80
photo-72.jpg,1,1248,1273,1000,1082,97.00,3264,2448,25,82
photo-72.jpg,1,1298,1323,1000,1080,16.90,3264,2448,25,80
photo-72.jpg,1,1347,1372,1000,1080,19.75,3264,2448,25,80
photo-72.jpg,1,1199,1224,827,891,0.00,3264,2448,25,64
photo-72.jpg,1,1199,1223,1157,1168,1,3264,2448,24,11
photo-72.jpg,1,1195,1222,350,431,13.90,3264,2448,27,81
photo-72.jpg,1,1246,1273,350,451,388.00,3264,2448,27,101
photo-72.jpg,1,1296,1323,350,431,16.90,3264,2448,27,81
photo-72.jpg,1,1346,1372,354,433,79.01,3264,2448,26,79
photo-72.jpg,1,1249,1274,827,890,0.00,3264,2448,25,63
photo-72.jpg,1,1249,1272,1153,1171,4,3264,2448,23,18
photo-72.jpg,1,1298,1322,1157,1168,1,3264,2448,24,11
photo-72.jpg,1,1299,1324,827,890,0.00,3264,2448,25,63
photo-72.jpg,1,1348,1373,827,890,0.00,3264,2448,25,63
photo-72.jpg,1,1348,1371,1153,1171,4,3264,2448,23,18
photo-73.jpg,2,1167,1207,1651,1948,Pomace Olive Oil 4lt,3264,2448,40,297
photo-73.jpg,2,1209,1257,1472,1949,Tomatoes Crushed BULK 10kg,3264,2448,48,477
photo-73.jpg,2,1258,1305,1487,1945,Fire Roast Pepper STRIP 4.2kg,3264,2448,47,458
photo-73.jpg,2,1317,1354,1727,1944,BBQ Sauce 3lt,3264,2448,37,217
photo-73.jpg,2,1358,1403,1535,1942,BROWN Pizza Box 100x12,3264,2448,45,407
photo-73.jpg,2,1408,1452,1486,1940,Pizza InsertIO Cardboard100s,3264,2448,44,454
photo-73.jpg,2,1457,1503,1504,1939,Mozzarella Traditional [6x2kg],3264,2448,46,435
photo-73.jpg,2,1507,1552,1499,1938,Cream Thickened Caterers 5lt,3264,2448,45,439
photo-73.jpg,2,1559,1603,1527,1938,Anchovie Tin Oil 720g [Italy],3264,2448,44,411
photo-73.jpg,1,1158,1187,360,447,42.00,3264,2448,29,87
photo-73.jpg,1,1208,1237,357,443,27.80,3264,2448,29,86
photo-73.jpg,1,1257,1287,356,439,16.30,3264,2448,30,83
photo-73.jpg,1,1308,1337,353,439,66.00,3264,2448,29,86
photo-73.jpg,1,1357,1387,350,437,41.27,3264,2448,30,87
photo-73.jpg,1,1407,1439,347,452,582.00,3264,2448,32,105
photo-73.jpg,1,1457,1488,345,431,67.60,3264,2448,31,86
photo-73.jpg,1,1509,1539,342,426,13.95,3264,2448,30,84
photo-73.jpg,3,1179,1209,2060,2156,ANTO,3264,2448,30,96
photo-73.jpg,3,1229,1258,2059,2154,ANTO,3264,2448,29,95
photo-73.jpg,3,1277,1307,2035,2152,NESTO,3264,2448,30,117
photo-73.jpg,3,1327,1357,2034,2150,SUNSH,3264,2448,30,116
photo-73.jpg,3,1376,1405,2037,2149,PERFE,3264,2448,29,112
photo-73.jpg,3,1426,1455,2048,2148,FIRST,3264,2448,29,100
photo-73.jpg,3,1476,1504,2038,2148,ALESS,3264,2448,28,110
photo-73.jpg,3,1525,1554,2044,2144,D/FAR,3264,2448,29,100
photo-73.jpg,3,1139,1171,1012,1180,1- 18.60,3264,2448,32,168
photo-73.jpg,1,1188,1218,1009,1091,14.00,3264,2448,30,82
photo-73.jpg,1,1237,1267,1008,1089,13.90,3264,2448,30,81
photo-73.jpg,1,1131,1159,840,903,0.00,3264,2448,28,63
photo-73.jpg,1,1180,1209,837,902,0.00,3264,2448,29,65
photo-73.jpg,1,1245,1271,1161,1179,2,3264,2448,26,18
photo-73.jpg,1,1229,1258,836,900,0.00,3264,2448,29,64
photo-73.jpg,1,1294,1320,1159,1177,2,3264,2448,26,18
photo-73.jpg,1,1286,1315,1006,1070,8.15,3264,2448,29,64
photo-73.jpg,1,1279,1307,834,898,0.00,3264,2448,28,64
photo-73.jpg,3,1332,1368,1124,1176,2^,3264,2448,36,52
photo-73.jpg,1,1336,1366,1004,1086,30.00,3264,2448,30,82
photo-73.jpg,1,1329,1357,831,895,0.00,3264,2448,28,64
photo-73.jpg,1,1320,1348,614,679,6.00,3264,2448,28,65
photo-73.jpg,3,1392,1418,1109,1173,4-'*',3264,2448,26,64
photo-73.jpg,1,1385,1415,1001,1066,9.38,3264,2448,30,65
photo-73.jpg,3,1432,1469,1115,1172,6*'',3264,2448,37,57
photo-73.jpg,1,1435,1466,1000,1082,97.00,3264,2448,31,82
photo-73.jpg,3,1487,1519,1112,1170,4*^,3264,2448,32,58
photo-73.jpg,1,1486,1516,997,1079,16.90,3264,2448,30,82
photo-73.jpg,3,1520,1570,995,1164,\S 13.95,3264,2448,50,169
photo-73.jpg,1,1378,1407,828,893,0.00,3264,2448,29,65
photo-73.jpg,1,1370,1399,613,676,3.75,3264,2448,29,63
photo-73.jpg,1,1428,1457,826,890,0.00,3264,2448,29,64
photo-73.jpg,1,1478,1507,823,888,0.00,3264,2448,29,65
photo-73.jpg,3,1575,1605,2071,2145,ALPI,3264,2448,30,74
photo-73.jpg,1,1531,1560,821,885,0.00,3264,2448,29,64
photo-73.jpg,1,1581,1609,819,884,0.00,3264,2448,28,65
photo-74.jpg,2,1145,1178,1702,2042,Sweet Chilli Sauce 4.5ft,3264,2448,33,340
photo-74.jpg,2,1194,1231,1745,2041,Vinegar Balsamic 5It,3264,2448,37,296
photo-74.jpg,2,1239,1275,1636,2039,BROWN Pizza Box 100x12,3264,2448,36,403
photo-74.jpg,2,1285,1323,1590,2038,Pizza InsertIO Cardboard 100s,3264,2448,38,448
photo-74.jpg,2,1335,1372,1608,2037,Mozzarella Traditional [6x2kg],3264,2448,37,429
photo-74.jpg,2,1383,1421,1603,2037,Cream Thickened Caterers 5ft,3264,2448,38,434
photo-74.jpg,2,1435,1470,1695,2035,Semi Dried Tomato 5kg,3264,2448,35,340
photo-74.jpg,2,1481,1518,1581,2033,Prawn Meat 31/40 GARLIC 1kg,3264,2448,37,452
photo-74.jpg,3,1150,1176,2129,2245,MPLOY,3264,2448,26,116
photo-74.jpg,3,1200,1226,2130,2246,TOSCH,3264,2448,26,116
photo-74.jpg,3,1249,1274,2133,2243,PERFE,3264,2448,25,110
photo-74.jpg,3,1297,1323,2146,2243,FIRST,3264,2448,26,97
photo-74.jpg,3,1346,1372,2135,2244,ALESS,3264,2448,26,109
photo-74.jpg,3,1395,1421,2142,2241,D/FAR,3264,2448,26,99
photo-74.jpg,3,1444,1470,2128,2241,GLOBL,3264,2448,26,113
photo-74.jpg,3,1492,1518,2127,2239,NEPTU,3264,2448,26,112
photo-74.jpg,1,1131,1153,1272,1283,1,3264,2448,22,11
photo-74.jpg,1,1126,1151,1120,1196,16.88,3264,2448,25,76
photo-74.jpg,1,1179,1202,1270,1282,1,3264,2448,23,12
photo-74.jpg,1,1174,1200,1118,1196,17.54,3264,2448,26,78
photo-74.jpg,1,1228,1251,1269,1280,1,3264,2448,23,11
photo-74.jpg,1,1222,1248,1117,1195,30.00,3264,2448,26,78
photo-74.jpg,1,1120,1146,952,1012,0.00,3264,2448,26,60
photo-74.jpg,1,1105,1132,496,574,16.88,3264,2448,27,78
photo-74.jpg,1,1154,1181,493,571,17.54,3264,2448,27,78
photo-74.jpg,1,1202,1229,492,572,33.00,3264,2448,27,80
photo-74.jpg,1,1249,1277,490,568,10.32,3264,2448,28,78
photo-74.jpg,1,1298,1326,488,588,485.00,3264,2448,28,100
photo-74.jpg,1,1346,1373,487,565,16.90,3264,2448,27,78
photo-74.jpg,1,1395,1422,485,566,43.75,3264,2448,27,81
photo-74.jpg,1,1443,1470,487,562,39.51,3264,2448,27,75
photo-74.jpg,1,1168,1195,950,1011,0.00,3264,2448,27,61
photo-74.jpg,1,1217,1243,949,1009,0.00,3264,2448,26,60
photo-74.jpg,1,1211,1236,740,801,3.00,3264,2448,25,61
photo-74.jpg,1,1259,1284,738,799,0.94,3264,2448,25,61
photo-74.jpg,1,1276,1299,1267,1279,1,3264,2448,23,12
photo-74.jpg,1,1271,1297,1115,1176,9.38,3264,2448,26,61
photo-74.jpg,1,1265,1292,947,1008,0.00,3264,2448,27,61
photo-74.jpg,1,1325,1349,1262,1279,5,3264,2448,24,17
photo-74.jpg,1,1320,1346,1114,1192,97.00,3264,2448,26,78
photo-74.jpg,1,1373,1397,1264,1277,1,3264,2448,24,13
photo-74.jpg,1,1368,1394,1111,1189,16.90,3264,2448,26,78
photo-74.jpg,1,1422,1446,1263,1274,1,3264,2448,24,11
photo-74.jpg,1,1417,1443,1110,1190,43.75,3264,2448,26,80
photo-74.jpg,1,1469,1494,1258,1276,2,3264,2448,25,18
photo-74.jpg,1,1465,1491,1108,1186,19.75,3264,2448,26,78
photo-74.jpg,1,1314,1341,946,1007,0.00,3264,2448,27,61
photo-74.jpg,1,1362,1390,943,1005,0.00,3264,2448,28,62
photo-74.jpg,1,1411,1438,942,1004,0.00,3264,2448,27,62
photo-74.jpg,1,1459,1486,940,1002,0.00,3264,2448,27,62
photo-74.jpg,1,1508,1534,939,1000,0.00,3264,2448,26,61
photo-75.jpg,2,1101,1131,1661,1958,Pomace Olive Oil 4lt,3264,2448,30,297
photo-75.jpg,2,1146,1181,1483,1959,Tomatoes Crushed BULK 10kg,3264,2448,35,476
photo-75.jpg,2,1196,1233,1499,1956,Fire Roast Pepper STRIP 4.2kg,3264,2448,37,457
photo-75.jpg,2,1245,1280,1548,1954,BROWN Pizza Box 100x12,3264,2448,35,406
photo-75.jpg,2,1294,1330,1502,1954,Pizza InsertIO Cardboard100s,3264,2448,36,452
photo-75.jpg,2,1342,1379,1520,1953,Mozzarella Traditional [6x2kg],3264,2448,37,433
photo-75.jpg,2,1393,1429,1516,1953,Cream Thickened Caterers 5lt,3264,2448,36,437
photo-75.jpg,2,1442,1484,1579,1950,Eggs Large [600gx15doz],3264,2448,42,371
photo-75.jpg,2,1490,1528,1500,1950,Gnocchi Potato Precooked 1kg,3264,2448,38,450
photo-75.jpg,2,1539,1575,1493,1948,Prawn Meat 31/40 GARLIC 1kg,3264,2448,36,455
photo-75.jpg,1,1066,1094,392,473,17.00,3264,2448,28,81
photo-75.jpg,1,1116,1144,390,474,55.34,3264,2448,28,84
photo-75.jpg,1,1165,1194,389,474,27.80,3264,2448,29,85
photo-75.jpg,1,1215,1242,387,471,33.00,3264,2448,27,84
photo-75.jpg,1,1263,1292,386,469,51.59,3264,2448,29,83
photo-75.jpg,1,1313,1341,384,488,679.00,3264,2448,28,104
photo-75.jpg,1,1362,1390,382,467,50.70,3264,2448,28,85
photo-75.jpg,1,1411,1438,381,465,39.50,3264,2448,27,84
photo-75.jpg,1,1460,1487,380,465,20.85,3264,2448,27,85
photo-75.jpg,1,1510,1536,383,462,79.01,3264,2448,26,79
photo-75.jpg,3,1104,1131,2070,2164,ANTO,3264,2448,27,94
photo-75.jpg,3,1153,1180,2060,2161,FIAMA,3264,2448,27,101
photo-75.jpg,3,1203,1230,2047,2159,NESTO,3264,2448,27,112
photo-75.jpg,3,1251,1279,2049,2157,PERFE,3264,2448,28,108
photo-75.jpg,3,1301,1330,2062,2158,FIRST,3264,2448,29,96
photo-75.jpg,3,1350,1379,2051,2158,ALESS,3264,2448,29,107
photo-75.jpg,3,1401,1427,2057,2155,D/FAR,3264,2448,26,98
photo-75.jpg,3,1449,1477,2065,2155,PACE,3264,2448,28,90
photo-75.jpg,1,1080,1107,858,921,0.00,3264,2448,27,63
photo-75.jpg,1,1085,1112,1027,1107,17.00,3264,2448,27,80
photo-75.jpg,1,1134,1161,1026,1106,18.45,3264,2448,27,80
photo-75.jpg,3,1187,1212,1148,1193,2^,3264,2448,25,45
photo-75.jpg,1,1183,1210,1025,1105,13.90,3264,2448,27,80
photo-75.jpg,3,1236,1261,1144,1190,1,3264,2448,25,46
photo-75.jpg,1,1231,1259,1024,1105,30.00,3264,2448,28,81
photo-75.jpg,3,1278,1311,1138,1190,5/,3264,2448,33,52
photo-75.jpg,1,1281,1308,1022,1086,9.38,3264,2448,27,64
photo-75.jpg,3,1327,1360,1142,1189,7^,3264,2448,33,47
photo-75.jpg,1,1331,1358,1021,1102,97.00,3264,2448,27,81
photo-75.jpg,3,1378,1409,1151,1187,Y,3264,2448,31,36
photo-75.jpg,1,1380,1406,1020,1098,16.90,3264,2448,26,78
photo-75.jpg,1,1429,1456,1019,1099,39.50,3264,2448,27,80
photo-75.jpg,1,1090,1115,1181,1193,1,3264,2448,25,12
photo-75.jpg,3,1134,1164,1151,1194,Y',3264,2448,30,43
photo-75.jpg,1,1129,1156,855,919,0.00,3264,2448,27,64
photo-75.jpg,1,1178,1205,854,918,0.00,3264,2448,27,64
photo-75.jpg,1,1227,1254,853,917,0.00,3264,2448,27,64
photo-75.jpg,1,1222,1250,642,706,3.00,3264,2448,28,64
photo-75.jpg,1,1277,1304,852,916,0.00,3264,2448,27,64
photo-75.jpg,1,1272,1299,641,705,4.69,3264,2448,27,64
photo-75.jpg,1,1326,1353,851,914,0.00,3264,2448,27,63
photo-75.jpg,1,1375,1402,849,912,0.00,3264,2448,27,63
photo-75.jpg,1,1424,1451,848,910,0.00,3264,2448,27,62
photo-75.jpg,3,1432,1467,1140,1183,V,3264,2448,35,43
photo-75.jpg,3,1499,1525,2093,2156,ZINI,3264,2448,26,63
photo-75.jpg,1,1473,1501,847,909,0.00,3264,2448,28,62
photo-75.jpg,1,1478,1505,1018,1080,6.95,3264,2448,27,62
photo-75.jpg,1,1482,1508,1167,1185,3,3264,2448,26,18
photo-75.jpg,3,1547,1575,2042,2153,NEPTU,3264,2448,28,111
photo-75.jpg,3,1523,1558,1016,1185,4/^ 19.75,3264,2448,35,169
photo-75.jpg,1,1523,1550,846,908,0.00,3264,2448,27,62
photo-75.jpg,1,1573,1599,844,907,0.00,3264,2448,26,63
photo-76.jpg,2,1047,1081,1675,1971,Pomace Olive Oil 4lt,3264,2448,34,296
photo-76.jpg,2,1091,1130,1511,1970,Fire Roast Pepper STRIP 4.2kg,3264,2448,39,459
photo-76.jpg,2,1149,1180,1755,1968,BBQ Sauce 3lt,3264,2448,31,213
photo-76.jpg,2,1190,1228,1561,1967,BROWN Pizza Box 100x12“,3264,2448,38,406
photo-76.jpg,2,1241,1278,1577,1966,BROWN Pizza Box 50x15,3264,2448,37,389
photo-76.jpg,2,1288,1326,1512,1965,Pizza InsertIO Cardboard 100s,3264,2448,38,453
photo-76.jpg,2,1338,1376,1529,1964,Mozzarella Traditional [6x2kg],3264,2448,38,435
photo-76.jpg,2,1388,1426,1524,1963,Cream Thickened Caterers 5lt,3264,2448,38,439
photo-76.jpg,2,1439,1482,1588,1961,Eggs Large [600gx15doz],3264,2448,43,373
photo-76.jpg,1,1007,1035,395,477,17.00,3264,2448,28,82
photo-76.jpg,1,1056,1085,394,477,27.80,3264,2448,29,83
photo-76.jpg,3,1053,1080,2086,2180,ANTO,3264,2448,27,94
photo-76.jpg,3,1103,1129,2063,2176,NESTO,3264,2448,26,113
photo-76.jpg,3,1152,1180,2062,2175,SUNSH,3264,2448,28,113
photo-76.jpg,3,1202,1228,2065,2173,PERFE,3264,2448,26,108
photo-76.jpg,3,1250,1277,2064,2172,PERFE,3264,2448,27,108
photo-76.jpg,3,1300,1327,2076,2171,FIRST,3264,2448,27,95
photo-76.jpg,3,1349,1377,2065,2172,ALESS,3264,2448,28,107
photo-76.jpg,3,1399,1426,2071,2168,D/FAR,3264,2448,27,97
photo-76.jpg,3,1448,1477,2078,2167,PACE,3264,2448,29,89
photo-76.jpg,1,1035,1058,1192,1202,1,3264,2448,23,10
photo-76.jpg,1,1029,1057,1037,1115,17.00,3264,2448,28,78
photo-76.jpg,1,1084,1108,1186,1203,2,3264,2448,24,17
photo-76.jpg,1,1078,1106,1035,1114,13.90,3264,2448,28,79
photo-76.jpg,1,1025,1051,865,928,0.00,3264,2448,26,63
photo-76.jpg,1,1074,1100,863,926,0.00,3264,2448,26,63
photo-76.jpg,1,1106,1132,392,456,8.15,3264,2448,26,64
photo-76.jpg,1,1123,1149,861,925,0.00,3264,2448,26,64
photo-76.jpg,1,1127,1154,1034,1096,8.15,3264,2448,27,62
photo-76.jpg,1,1133,1157,1189,1200,1,3264,2448,24,11
photo-76.jpg,1,1155,1184,390,473,33.00,3264,2448,29,83
photo-76.jpg,1,1204,1233,389,487,110.00,3264,2448,29,98
photo-76.jpg,1,1254,1282,387,470,41.27,3264,2448,28,83
photo-76.jpg,1,1303,1332,385,485,388.00,3264,2448,29,100
photo-76.jpg,1,1352,1380,383,465,50.70,3264,2448,28,82
photo-76.jpg,1,1402,1430,381,463,39.50,3264,2448,28,82
photo-76.jpg,1,1164,1191,646,708,3.00,3264,2448,27,62
photo-76.jpg,1,1172,1198,860,923,0.00,3264,2448,26,63
photo-76.jpg,1,1181,1206,1187,1198,1,3264,2448,25,11
photo-76.jpg,1,1176,1204,1032,1112,30.00,3264,2448,28,80
photo-76.jpg,1,1231,1254,1181,1199,4,3264,2448,23,18
photo-76.jpg,1,1225,1253,1030,1111,25.00,3264,2448,28,81
photo-76.jpg,1,1213,1241,644,723,10.00,3264,2448,28,79
photo-76.jpg,1,1221,1247,858,921,0.00,3264,2448,26,63
photo-76.jpg,1,1263,1289,642,705,3.75,3264,2448,26,63
photo-76.jpg,1,1269,1296,856,920,0.00,3264,2448,27,64
photo-76.jpg,1,1274,1301,1029,1090,9.38,3264,2448,27,61
photo-76.jpg,1,1280,1303,1180,1197,4,3264,2448,23,17
photo-76.jpg,1,1319,1345,855,918,0.00,3264,2448,26,63
photo-76.jpg,1,1329,1353,1178,1196,4,3264,2448,24,18
photo-76.jpg,1,1323,1352,1027,1107,97.00,3264,2448,29,80
photo-76.jpg,1,1378,1403,1177,1194,3,3264,2448,25,17
photo-76.jpg,1,1373,1401,1026,1105,16.90,3264,2448,28,79
photo-76.jpg,1,1428,1452,1180,1190,1,3264,2448,24,10
photo-76.jpg,1,1422,1451,1024,1104,39.50,3264,2448,29,80
photo-76.jpg,1,1368,1395,853,917,0.00,3264,2448,27,64
photo-76.jpg,1,1418,1445,852,914,0.00,3264,2448,27,62
photo-76.jpg,1,1467,1494,849,913,0.00,3264,2448,27,64
photo-77.jpg,2,1059,1089,1634,1931,Pomace Olive Oil 4lt,3264,2448,30,297
photo-77.jpg,2,1106,1142,1470,1931,Fire Roast Pepper STRIP 4.2kg,3264,2448,36,461
photo-77.jpg,2,1160,1192,1728,1930,Pine Nuts 1kg,3264,2448,32,202
photo-77.jpg,2,1207,1239,1521,1930,BROWN Pizza Box 100x12”,3264,2448,32,409
photo-77.jpg,2,1256,1288,1475,1930,Pizza InsertlO” Cardboard 100s,3264,2448,32,455
photo-77.jpg,2,1306,1340,1494,1931,Mozzarella Traditional [6x2kg],3264,2448,34,437
photo-77.jpg,2,1356,1388,1489,1930,Cream Thickened Caterers 5lt,3264,2448,32,441
photo-77.jpg,2,1406,1438,1468,1929,Prawn Meat 31/40 GARLIC 1kg,3264,2448,32,461
photo-77.jpg,3,1058,1086,2047,2140,ANTO,3264,2448,28,93
photo-77.jpg,3,1108,1137,2025,2138,NESTO,3264,2448,29,113
photo-77.jpg,3,1158,1186,2028,2139,GLOBL,3264,2448,28,111
photo-77.jpg,3,1208,1236,2027,2138,PERFE,3264,2448,28,111
photo-77.jpg,3,1259,1285,2041,2138,FIRST,3264,2448,26,97
photo-77.jpg,3,1308,1336,2031,2139,ALESS,3264,2448,28,108
photo-77.jpg,3,1358,1385,2038,2136,D/FAR,3264,2448,27,98
photo-77.jpg,3,1408,1436,2026,2136,NEPTU,3264,2448,28,110
photo-77.jpg,3,1040,1076,985,1154,1^17.00,3264,2448,36,169
photo-77.jpg,1,1101,1127,1139,1156,2,3264,2448,26,17
photo-77.jpg,1,1098,1125,985,1065,13.90,3264,2448,27,80
photo-77.jpg,3,1143,1176,985,1153,1 ^ 40.95,3264,2448,33,168
photo-77.jpg,3,1186,1226,984,1156,2^ 30.00,3264,2448,40,172
photo-77.jpg,1,1031,1059,326,410,17.00,3264,2448,28,84
photo-77.jpg,1,1082,1111,326,412,27.80,3264,2448,29,86
photo-77.jpg,1,1133,1161,326,412,40.95,3264,2448,28,86
photo-77.jpg,1,1184,1212,325,411,66.00,3264,2448,28,86
photo-77.jpg,1,1234,1262,324,409,51.59,3264,2448,28,85
photo-77.jpg,1,1285,1314,323,427,388.00,3264,2448,29,104
photo-77.jpg,1,1336,1364,322,407,50.70,3264,2448,28,85
photo-77.jpg,1,1388,1415,325,405,39.51,3264,2448,27,80
photo-77.jpg,1,1044,1071,811,875,0.00,3264,2448,27,64
photo-77.jpg,1,1095,1121,810,873,0.00,3264,2448,26,63
photo-77.jpg,1,1145,1171,810,873,0.00,3264,2448,26,63
photo-77.jpg,1,1195,1221,809,873,0.00,3264,2448,26,64
photo-77.jpg,1,1190,1218,590,655,6.00,3264,2448,28,65
photo-77.jpg,1,1251,1276,1137,1153,5,3264,2448,25,16
photo-77.jpg,1,1249,1274,983,1046,9.38,3264,2448,25,63
photo-77.jpg,1,1245,1272,808,871,0.00,3264,2448,27,63
photo-77.jpg,1,1242,1268,589,654,4.69,3264,2448,26,65
photo-77.jpg,3,1300,1326,1103,1154,4 *,3264,2448,26,51
photo-77.jpg,1,1298,1325,982,1064,97.00,3264,2448,27,82
photo-77.jpg,3,1338,1377,981,1152,3^ 16.90,3264,2448,39,171
photo-77.jpg,3,1398,1427,980,1152,2/ 19.75,3264,2448,29,172
photo-77.jpg,1,1295,1322,807,871,0.00,3264,2448,27,64
photo-77.jpg,1,1345,1372,806,869,0.00,3264,2448,27,63
photo-77.jpg,1,1397,1423,805,869,0.00,3264,2448,26,64
photo-77.jpg,1,1448,1474,805,869,0.00,3264,2448,26,64
photo-78.jpg,2,1053,1087,1449,1934,Tomatoes Crushed BULK 10kg,3264,2448,34,485
photo-78.jpg,2,1103,1140,1464,1932,Fire Roast Pepper STRIP 4.2kg,3264,2448,37,468
photo-78.jpg,2,1155,1187,1517,1933,BROWN Pizza Box 100x12,3264,2448,32,416
photo-78.jpg,2,1203,1237,1490,1932,Mozzarella Traditional [6x2kg],3264,2448,34,442
photo-78.jpg,2,1256,1287,1645,1933,Cream Sour Lite 2lt,3264,2448,31,288
photo-78.jpg,2,1304,1338,1485,1932,Cream Thickened Caterers 5lt,3264,2448,34,447
photo-78.jpg,2,1355,1391,1516,1934,Anchovie Tin Oil 720g [Italy],3264,2448,36,418
photo-78.jpg,2,1405,1440,1463,1931,Prawn Meat 31/40 GARLIC 1kg,3264,2448,35,468
photo-78.jpg,3,1045,1106,1063,1148,3>,3264,2448,61,85
photo-78.jpg,3,1090,1120,1091,1146,1 ',3264,2448,30,55
photo-78.jpg,1,1018,1046,308,396,42.00,3264,2448,28,88
photo-78.jpg,1,1069,1098,307,391,13.90,3264,2448,29,84
photo-78.jpg,1,1119,1149,305,391,33.00,3264,2448,30,86
photo-78.jpg,1,1170,1200,304,410,485.00,3264,2448,30,106
photo-78.jpg,1,1220,1250,302,387,12.16,3264,2448,30,85
photo-78.jpg,1,1271,1300,300,385,16.90,3264,2448,29,85
photo-78.jpg,1,1323,1352,300,383,13.95,3264,2448,29,83
photo-78.jpg,1,1374,1404,298,382,59.26,3264,2448,30,84
photo-78.jpg,1,1042,1068,976,1057,14.00,3264,2448,26,81
photo-78.jpg,1,1092,1120,975,1057,13.90,3264,2448,28,82
photo-78.jpg,3,1141,1171,1099,1145,1 ',3264,2448,30,46
photo-78.jpg,1,1143,1170,975,1057,30.00,3264,2448,27,82
photo-78.jpg,3,1181,1222,1085,1146,Sy,3264,2448,41,61
photo-78.jpg,1,1193,1220,974,1056,97.00,3264,2448,27,82
photo-78.jpg,3,1227,1271,973,1143,1 ^ 12.16,3264,2448,44,170
photo-78.jpg,3,1277,1321,972,1143,1^ 16.90,3264,2448,44,171
photo-78.jpg,3,1323,1372,1079,1142,1 ^,3264,2448,49,63
photo-78.jpg,1,1344,1371,970,1052,13.95,3264,2448,27,82
photo-78.jpg,3,1385,1423,1086,1142,3 /,3264,2448,38,56
photo-78.jpg,1,1395,1422,970,1050,19.75,3264,2448,27,80
photo-78.jpg,1,1035,1062,799,864,0.00,3264,2448,27,65
photo-78.jpg,3,1057,1083,2051,2145,ANTO,3264,2448,26,94
photo-78.jpg,3,1107,1134,2028,2144,NESTO,3264,2448,27,116
photo-78.jpg,3,1158,1184,2032,2143,PERFE,3264,2448,26,111
photo-78.jpg,3,1208,1234,2036,2145,ALESS,3264,2448,26,109
photo-78.jpg,3,1259,1284,2043,2142,D/FAR,3264,2448,25,99
photo-78.jpg,3,1310,1335,2043,2143,D/FAR,3264,2448,25,100
photo-78.jpg,1,1086,1113,798,863,0.00,3264,2448,27,65
photo-78.jpg,1,1131,1158,574,638,3.00,3264,2448,27,64
photo-78.jpg,1,1137,1164,797,861,0.00,3264,2448,27,64
photo-78.jpg,1,1187,1214,796,860,0.00,3264,2448,27,64
photo-78.jpg,1,1237,1264,795,859,0.00,3264,2448,27,64
photo-78.jpg,1,1288,1315,793,858,0.00,3264,2448,27,65
photo-78.jpg,3,1360,1386,2072,2146,ALPI,3264,2448,26,74
photo-78.jpg,1,1339,1366,793,857,0.00,3264,2448,27,64
photo-78.jpg,3,1411,1437,2031,2143,NEPTU,3264,2448,26,112
photo-78.jpg,1,1390,1417,792,856,0.00,3264,2448,27,64
photo-78.jpg,1,1441,1469,790,854,0.00,3264,2448,28,64
photo-79.jpg,2,1106,1136,1658,1959,Kalamata Sliced 10kg,3264,2448,30,301
photo-79.jpg,2,1150,1183,1525,1959,Pizza InsertIO Cardboard 100s,3264,2448,33,434
photo-79.jpg,2,1198,1230,1542,1958,Mozzarella Traditional [6x2kg],3264,2448,32,416
photo-79.jpg,2,1245,1278,1538,1960,Cream Thickened Caterers 5lt,3264,2448,33,422
photo-79.jpg,2,1292,1324,1518,1958,Prawn Meat 31/40 GARLIC 1kg,3264,2448,32,440
photo-79.jpg,3,1107,1133,2052,2159,GLOBL,3264,2448,26,107
photo-79.jpg,3,1156,1180,2066,2157,FIRST,3264,2448,24,91
photo-79.jpg,3,1202,1227,2056,2159,ALESS,3264,2448,25,103
photo-79.jpg,3,1251,1275,2063,2157,D/FAR,3264,2448,24,94
photo-79.jpg,3,1298,1322,2051,2156,NEPTU,3264,2448,24,105
photo-79.jpg,1,1098,1122,1211,1221,1,3264,2448,24,10
photo-79.jpg,1,1093,1119,1062,1140,62.02,3264,2448,26,78
photo-79.jpg,1,1090,1116,898,957,0.00,3264,2448,26,59
photo-79.jpg,1,1078,1105,446,524,62.02,3264,2448,27,78
photo-79.jpg,1,1126,1153,444,522,30.95,3264,2448,27,78
photo-79.jpg,1,1174,1201,442,539,388.00,3264,2448,27,97
photo-79.jpg,1,1221,1247,441,518,16.90,3264,2448,26,77
photo-79.jpg,1,1269,1295,443,518,39.51,3264,2448,26,75
photo-79.jpg,1,1134,1158,694,750,2.81,3264,2448,24,56
photo-79.jpg,1,1145,1169,1206,1221,3,3264,2448,24,15
photo-79.jpg,1,1141,1166,1061,1120,9.38,3264,2448,25,59
photo-79.jpg,1,1138,1163,896,955,0.00,3264,2448,25,59
photo-79.jpg,1,1193,1216,1205,1221,4,3264,2448,23,16
photo-79.jpg,1,1188,1214,1059,1136,97.00,3264,2448,26,77
photo-79.jpg,1,1239,1263,1207,1218,1,3264,2448,24,11
photo-79.jpg,1,1235,1260,1058,1134,16.90,3264,2448,25,76
photo-79.jpg,1,1286,1310,1204,1219,2,3264,2448,24,15
photo-79.jpg,1,1283,1308,1058,1133,19.75,3264,2448,25,75
photo-79.jpg,1,1185,1210,895,954,0.00,3264,2448,25,59
photo-79.jpg,1,1232,1257,893,954,0.00,3264,2448,25,61
photo-79.jpg,1,1279,1305,893,952,0.00,3264,2448,26,59
photo-79.jpg,1,1327,1352,891,951,0.00,3264,2448,25,60
photo-80.jpg,2,1137,1167,1690,1982,Pomace Olive Oil 4lt,3264,2448,30,292
photo-80.jpg,2,1181,1215,1515,1983,Tomatoes Crushed BULK 10kg,3264,2448,34,468
photo-80.jpg,2,1231,1267,1529,1981,Fire Roast Pepper STRIP 4.2kg,3264,2448,36,452
photo-80.jpg,2,1284,1314,1768,1980,BBQ Sauce 3lt,3264,2448,30,212
photo-80.jpg,2,1328,1362,1578,1979,BROWN Pizza Box 100x12,3264,2448,34,401
photo-80.jpg,2,1376,1410,1552,1979,Mozzarella Traditional [6x2kg],3264,2448,34,427
photo-80.jpg,2,1428,1464,1691,1979,Ginger Crushed 2kg,3264,2448,36,288
photo-80.jpg,3,1140,1167,2094,2187,ANTO,3264,2448,27,93
photo-80.jpg,3,1188,1214,2094,2187,ANTO,3264,2448,26,93
photo-80.jpg,3,1236,1263,2072,2184,NESTO,3264,2448,27,112
photo-80.jpg,3,1286,1312,2071,2185,SUNSH,3264,2448,26,114
photo-80.jpg,3,1335,1361,2076,2182,PERFE,3264,2448,26,106
photo-80.jpg,3,1384,1410,2080,2186,ALESS,3264,2448,26,106
photo-80.jpg,3,1432,1458,2092,2184,GOLD,3264,2448,26,92
photo-80.jpg,1,1098,1124,431,510,17.00,3264,2448,26,79
photo-80.jpg,1,1146,1173,429,511,42.00,3264,2448,27,82
photo-80.jpg,1,1195,1222,427,509,27.80,3264,2448,27,82
photo-80.jpg,1,1244,1272,426,507,24.45,3264,2448,28,81
photo-80.jpg,1,1293,1321,423,504,33.00,3264,2448,28,81
photo-80.jpg,1,1341,1369,421,519,194.00,3264,2448,28,98
photo-80.jpg,1,1392,1418,423,500,20.41,3264,2448,26,77
photo-80.jpg,1,1124,1147,1216,1226,1,3264,2448,23,10
photo-80.jpg,1,1119,1145,1064,1141,17.00,3264,2448,26,77
photo-80.jpg,1,1172,1196,1210,1227,3,3264,2448,24,17
photo-80.jpg,1,1168,1194,1061,1140,14.00,3264,2448,26,79
photo-80.jpg,1,1220,1245,1209,1227,2,3264,2448,25,18
photo-80.jpg,1,1217,1242,1060,1139,13.90,3264,2448,25,79
photo-80.jpg,1,1114,1139,895,956,0.00,3264,2448,25,61
photo-80.jpg,1,1162,1187,894,955,0.00,3264,2448,25,61
photo-80.jpg,1,1211,1236,891,953,0.00,3264,2448,25,62
photo-80.jpg,1,1269,1293,1208,1225,3,3264,2448,24,17
photo-80.jpg,1,1259,1285,889,952,0.00,3264,2448,26,63
photo-80.jpg,1,1265,1290,1059,1121,8.15,3264,2448,25,62
photo-80.jpg,1,1303,1328,677,739,3.00,3264,2448,25,62
photo-80.jpg,1,1318,1342,1211,1222,1,3264,2448,24,11
photo-80.jpg,1,1314,1340,1058,1137,30.00,3264,2448,26,79
photo-80.jpg,1,1366,1390,1205,1223,2,3264,2448,24,18
photo-80.jpg,1,1362,1388,1056,1136,97.00,3264,2448,26,80
photo-80.jpg,1,1415,1439,1208,1219,1,3264,2448,24,11
photo-80.jpg,1,1411,1437,1059,1135,20.41,3264,2448,26,76
photo-80.jpg,1,1309,1334,888,950,0.00,3264,2448,25,62
photo-80.jpg,1,1357,1382,886,949,0.00,3264,2448,25,63
photo-80.jpg,1,1406,1431,885,947,0.00,3264,2448,25,62
photo-80.jpg,1,1455,1480,883,945,0.00,3264,2448,25,62
photo-81.jpg,2,1275,1327,1454,1933,Primo Ham Shredded (Julienne) 2kg,3264,2448,52,479
photo-81.jpg,2,1337,1391,1456,1932,Primo Sliced Pepperoni (40mm) 2kg,3264,2448,54,476
photo-81.jpg,2,1401,1455,1460,1932,Thin Sliced Hungarian Salami 1.5kg,3264,2448,54,472
photo-81.jpg,2,1472,1519,1537,1927,Real Shredded Parmesan 2kg,3264,2448,47,390
photo-81.jpg,2,1539,1583,1594,1927,Zammit Diced Bacon 3kg,3264,2448,44,333
photo-81.jpg,2,1603,1647,1581,1923,WV 100% Basil Pesto 2kg,3264,2448,44,342
photo-81.jpg,3,1274,1307,415,528,100.00T,3264,2448,33,113
photo-81.jpg,3,1294,1328,830,898,4 V,3264,2448,34,68
photo-81.jpg,1,1291,1320,687,765,25.00,3264,2448,29,78
photo-81.jpg,3,1357,1394,828,894,31/,3264,2448,37,66
photo-81.jpg,1,1356,1386,683,759,19.00,3264,2448,30,76
photo-81.jpg,1,1420,1451,678,756,26.00,3264,2448,31,78
photo-81.jpg,1,1498,1524,870,901,11,3264,2448,26,31
photo-81.jpg,1,1486,1517,675,750,17.80,3264,2448,31,75
photo-81.jpg,1,1551,1582,671,749,23.50,3264,2448,31,78
photo-81.jpg,3,1340,1372,412,509,57.0UT,3264,2448,32,97
photo-81.jpg,3,1404,1437,407,505,52.00T,3264,2448,33,98
photo-81.jpg,3,1471,1503,403,515,195.80T,3264,2448,32,112
photo-81.jpg,3,1536,1567,397,496,23.50T,3264,2448,31,99
photo-82.jpg,2,1338,1376,1487,2001,Primo Ham Shredded (Julienne) 2kg,3264,2448,38,514
photo-82.jpg,2,1406,1445,1493,2001,Primo Sliced Pepperoni (40mm) 2kg,3264,2448,39,508
photo-82.jpg,2,1475,1513,1500,2004,Thin Sliced Hungarian Salami 15kg,3264,2448,38,504
photo-82.jpg,2,1544,1580,1585,2002,Real Shredded Parmesan 2kg,3264,2448,36,417
photo-82.jpg,2,1615,1649,1650,2004,Zammit Diced Bacon 3kg,3264,2448,34,354
photo-82.jpg,2,1685,1720,1712,2004,Caesar Dressing 1kg,3264,2448,35,292
photo-82.jpg,3,1313,1342,374,495,225.00T,3264,2448,29,121
photo-82.jpg,1,1319,1347,667,746,12.50,3264,2448,28,79
photo-82.jpg,1,1322,1351,874,907,18,3264,2448,29,33
photo-82.jpg,3,1382,1412,371,474,75.00T,3264,2448,30,103
photo-82.jpg,1,1388,1417,664,746,25.00,3264,2448,29,82
photo-82.jpg,1,1392,1420,872,889,3,3264,2448,28,17
photo-82.jpg,3,1453,1482,369,475,76.00T,3264,2448,29,106
photo-82.jpg,1,1458,1487,663,744,19.00,3264,2448,29,81
photo-82.jpg,1,1462,1490,870,890,4,3264,2448,28,20
photo-82.jpg,3,1522,1552,368,472,52.00T,3264,2448,30,104
photo-82.jpg,1,1528,1557,662,744,26.00,3264,2448,29,82
photo-82.jpg,1,1531,1559,870,887,2,3264,2448,28,17
photo-82.jpg,3,1594,1623,365,485,195-8GT,3264,2448,29,120
photo-82.jpg,1,1600,1627,660,739,17.80,3264,2448,27,79
photo-82.jpg,1,1603,1630,869,901,11,3264,2448,27,32
photo-82.jpg,3,1664,1693,361,449,7.50T,3264,2448,29,88
photo-82.jpg,1,1669,1697,657,722,750,3264,2448,28,65
photo-82.jpg,1,1674,1700,867,882,1,3264,2448,26,15
photo-83.jpg,2,1482,1522,1701,2127,Zammit Diced Bacon 3kg,3264,2448,40,426
photo-83.jpg,2,1536,1578,1523,2127,Primo Ham Shredded (Julienne) 2kg,3264,2448,42,604
photo-83.jpg,2,1593,1633,1643,2127,Real Shredded Parmesan 2kg,3264,2448,40,484
photo-83.jpg,2,1648,1690,1522,2127,Primo Sliced Pepperoni (40mm) 2kg,3264,2448,42,605
photo-83.jpg,2,1704,1746,1525,2129,Thin Sliced Hungarian Salami 1.5kg,3264,2448,42,604
photo-83.jpg,2,1761,1802,1688,2130,WV 100% Basil Pesto 2kg,3264,2448,41,442
photo-83.jpg,2,1818,1860,1758,2131,Capers in Vinegar 2kg,3264,2448,42,373
photo-83.jpg,2,1873,1915,1510,2133,Zammit Shredded Pizza Topping 3kg,3264,2448,42,623
photo-83.jpg,1,1478,1510,908,946,10,3264,2448,32,38
photo-83.jpg,1,1477,1509,729,819,17.50,3264,2448,32,90
photo-83.jpg,1,1534,1566,907,945,16,3264,2448,32,38
photo-83.jpg,1,1533,1565,727,819,12.50,3264,2448,32,92
photo-83.jpg,1,1592,1622,907,927,2,3264,2448,30,20
photo-83.jpg,1,1590,1621,726,822,26.00,3264,2448,31,96
photo-83.jpg,1,1648,1679,906,927,4,3264,2448,31,21
photo-83.jpg,1,1646,1678,725,821,25.00,3264,2448,32,96
photo-83.jpg,1,1704,1735,903,927,4,3264,2448,31,24
photo-83.jpg,1,1703,1735,724,816,19.00,3264,2448,32,92
photo-83.jpg,1,1761,1792,905,926,2,3264,2448,31,21
photo-83.jpg,1,1760,1792,724,819,23.50,3264,2448,32,95
photo-83.jpg,1,1818,1849,909,920,1,3264,2448,31,11
photo-83.jpg,1,1817,1849,723,814,13.80,3264,2448,32,91
photo-83.jpg,1,1875,1906,904,924,3,3264,2448,31,20
photo-83.jpg,1,1874,1905,721,813,18.00,3264,2448,31,92
photo-83.jpg,3,1475,1508,453,593,175.00T,3264,2448,33,140
photo-83.jpg,3,1531,1564,450,598,200.00T,3264,2448,33,148
photo-83.jpg,3,1588,1621,449,574,52.00T,3264,2448,33,125
photo-83.jpg,3,1644,1678,448,590,100.00T,3264,2448,34,142
photo-83.jpg,3,1701,1735,448,571,76.00T,3264,2448,34,123
photo-83.jpg,3,1758,1792,446,572,47.00T,3264,2448,34,126
photo-83.jpg,3,1816,1850,445,565,13.80T,3264,2448,34,120
photo-83.jpg,3,1873,1907,443,568,54.00T,3264,2448,34,125
photo-84.jpg,2,1331,1370,1607,2145,Primo Sliced Pepperoni (40mm) 2kg,3264,2448,39,538
photo-84.jpg,2,1401,1441,1614,2148,Thin Sliced Hungarian Salami 15kg,3264,2448,40,534
photo-84.jpg,2,1474,1510,1701,2145,Real Shredded Parmesan 2kg,3264,2448,36,444
photo-84.jpg,2,1546,1581,1771,2146,Zammit Diced Bacon 3kg,3264,2448,35,375
photo-84.jpg,3,1306,1336,452,558,75.00T,3264,2448,30,106
photo-84.jpg,1,1311,1341,751,836,25.00,3264,2448,30,85
photo-84.jpg,1,1316,1344,965,984,3,3264,2448,28,19
photo-84.jpg,3,1377,1408,450,553,19.00T,3264,2448,31,103
photo-84.jpg,1,1383,1412,750,831,19.00,3264,2448,29,81
photo-84.jpg,1,1388,1415,965,979,1,3264,2448,27,14
photo-84.jpg,3,1450,1480,447,552,52.00T,3264,2448,30,105
photo-84.jpg,1,1455,1485,747,831,26.00,3264,2448,30,84
photo-84.jpg,1,1459,1487,962,979,2,3264,2448,28,17
photo-84.jpg,3,1522,1552,444,566,175.00T,3264,2448,30,122
photo-84.jpg,1,1527,1557,745,827,17.50,3264,2448,30,82
photo-84.jpg,1,1531,1560,959,994,10,3264,2448,29,35
photo-85.jpg,2,1230,1267,1551,2068,Primo Sliced Pepperoni (40mm) 2kg,3264,2448,37,517
photo-85.jpg,2,1298,1335,1557,2070,Thin Sliced Hungarian Salami 1.5kg,3264,2448,37,513
photo-85.jpg,2,1368,1403,1641,2068,Real Shredded Parmesan 2kg,3264,2448,35,427
photo-85.jpg,2,1437,1471,1708,2069,Zammit Diced Bacon 3kg,3264,2448,34,361
photo-85.jpg,3,1205,1235,436,555,loo.oonr,3264,2448,30,119
photo-85.jpg,1,1213,1241,728,808,25.00,3264,2448,28,80
photo-85.jpg,1,1217,1244,932,951,4,3264,2448,27,19
photo-85.jpg,3,1274,1303,434,538,95.00T,3264,2448,29,104
photo-85.jpg,1,1281,1309,725,805,19.00,3264,2448,28,80
photo-85.jpg,1,1286,1313,931,949,5,3264,2448,27,18
photo-85.jpg,3,1343,1373,433,534,52.00T,3264,2448,30,101
photo-85.jpg,1,1349,1378,723,804,26.00,3264,2448,29,81
photo-85.jpg,1,1354,1381,929,946,2,3264,2448,27,17
photo-85.jpg,3,1413,1442,430,548,157.50T,3264,2448,29,118
photo-85.jpg,1,1418,1447,720,799,17.50,3264,2448,29,79
photo-85.jpg,1,1423,1450,927,945,9,3264,2448,27,18
photo-86.jpg,2,1259,1300,1546,2052,Primo Sliced Pepperoni (40mm) 2kg,3264,2448,41,506
photo-86.jpg,2,1326,1367,1552,2054,Thin Sliced Hungarian Salami 1.5kg,3264,2448,41,502
photo-86.jpg,2,1396,1434,1634,2050,Real Shredded Parmesan 2kg,3264,2448,38,416
photo-86.jpg,2,1465,1501,1697,2051,Zammit Diced Bacon 3kg,3264,2448,36,354
photo-86.jpg,1,1247,1272,943,963,4,3264,2448,25,20
photo-86.jpg,1,1242,1269,745,824,25.00,3264,2448,27,79
photo-86.jpg,3,1235,1263,464,579,100.00T,3264,2448,28,115
photo-86.jpg,1,1308,1335,743,819,19.00,3264,2448,27,76
photo-86.jpg,1,1313,1339,941,960,4,3264,2448,26,19
photo-86.jpg,3,1301,1329,463,561,76.00T,3264,2448,28,98
photo-86.jpg,1,1375,1403,741,819,26.00,3264,2448,28,78
photo-86.jpg,3,1380,1406,922,955,1-,3264,2448,26,33
photo-86.jpg,3,1368,1397,459,558,26.00T,3264,2448,29,99
photo-86.jpg,3,1410,1426,58,60,|,3264,2448,16,2
photo-86.jpg,1,1446,1474,938,955,8,3264,2448,28,17
photo-86.jpg,1,1442,1470,738,815,17.50,3264,2448,28,77
photo-86.jpg,3,1435,1464,457,571,140.00T,3264,2448,29,114
photo-87.jpg,2,1232,1269,1532,2057,Primo Sliced Pepperoni (40mm) 2kg,3264,2448,37,525
photo-87.jpg,2,1302,1339,1539,2060,Thin Sliced Hungarian Salami 1.5kg,3264,2448,37,521
photo-87.jpg,2,1371,1406,1624,2057,Real Shredded Parmesan 2kg,3264,2448,35,433
photo-87.jpg,2,1443,1480,1760,2056,Natural Yoghurt 5kg,3264,2448,37,296
photo-87.jpg,2,1512,1546,1691,2057,Zammit Diced Bacon 3kg,3264,2448,34,366
photo-87.jpg,3,1221,1249,413,530,100.00T,3264,2448,28,117
photo-87.jpg,1,1224,1252,701,782,25.00,3264,2448,28,81
photo-87.jpg,1,1226,1252,906,925,4,3264,2448,26,19
photo-87.jpg,3,1290,1319,411,514,95.00T,3264,2448,29,103
photo-87.jpg,1,1293,1321,700,778,19.00,3264,2448,28,78
photo-87.jpg,1,1295,1322,907,923,5,3264,2448,27,16
photo-87.jpg,3,1360,1389,410,510,52.0GT,3264,2448,29,100
photo-87.jpg,1,1364,1391,904,922,2,3264,2448,27,18
photo-87.jpg,1,1363,1391,698,779,26.00,3264,2448,28,81
photo-87.jpg,3,1429,1458,407,506,13.90T,3264,2448,29,99
photo-87.jpg,1,1433,1461,697,775,13.90,3264,2448,28,78
photo-87.jpg,1,1434,1461,904,918,1,3264,2448,27,14
photo-87.jpg,3,1500,1529,404,522,157.50T,3264,2448,29,118
photo-87.jpg,1,1504,1532,901,920,9,3264,2448,28,19
photo-87.jpg,1,1503,1531,694,774,17.50,3264,2448,28,80
photo-88.jpg,2,1299,1335,1567,2061,Primo Sliced Pepperoni (40mm) 2kg,3264,2448,36,494
photo-88.jpg,2,1365,1400,1574,2067,Thin Sliced Hungarian Salami 1.5kg,3264,2448,35,493
photo-88.jpg,2,1433,1465,1656,2064,Real Shredded Parmesan 2kg,3264,2448,32,408
photo-88.jpg,2,1501,1534,1784,2064,Natural Yoghurt 5kg,3264,2448,33,280
photo-88.jpg,2,1568,1600,1721,2065,Zammit Diced Bacon 3kg,3264,2448,32,344
photo-88.jpg,2,1634,1665,1768,2063,Beef Mince 90% R/W,3264,2448,31,295
photo-88.jpg,3,1278,1306,498,612,100.00T,3264,2448,28,114
photo-88.jpg,1,1285,1312,777,855,25.00,3264,2448,27,78
photo-88.jpg,1,1290,1315,974,993,4,3264,2448,25,19
photo-88.jpg,3,1345,1372,497,594,38.00T,3264,2448,27,97
photo-88.jpg,1,1351,1379,776,851,19.00,3264,2448,28,75
photo-88.jpg,1,1356,1381,974,990,2,3264,2448,25,16
photo-88.jpg,3,1413,1440,494,593,26.00T,3264,2448,27,99
photo-88.jpg,1,1418,1446,774,852,26.00,3264,2448,28,78
photo-88.jpg,1,1424,1448,973,987,1,3264,2448,24,14
photo-88.jpg,3,1480,1507,494,589,13.90T,3264,2448,27,95
photo-88.jpg,1,1485,1513,773,849,13.90,3264,2448,28,76
photo-88.jpg,1,1490,1514,973,986,1,3264,2448,24,13
photo-88.jpg,3,1548,1576,492,604,122.50T,3264,2448,28,112
photo-88.jpg,1,1553,1580,771,846,17.50,3264,2448,27,75
photo-88.jpg,1,1557,1582,970,986,7,3264,2448,25,16
photo-88.jpg,1,1620,1647,770,831,6.00,3264,2448,27,61
photo-88.jpg,1,1624,1650,969,1010,10.,3264,2448,26,41
photo-89.jpg,2,1267,1302,1566,2053,Primo Sliced Pepperoni (40mm) 2kg,3264,2448,35,487
photo-89.jpg,2,1331,1367,1573,2057,Thin Sliced Hungarian Salami 1.5kg,3264,2448,36,484
photo-89.jpg,2,1399,1430,1784,2055,Primo Chorizos R/W,3264,2448,31,271
photo-89.jpg,2,1462,1494,1653,2055,Real Shredded Parmesan 2kg,3264,2448,32,402
photo-89.jpg,2,1528,1561,1715,2056,Zammit Diced Bacon 3kg,3264,2448,33,341
photo-89.jpg,2,1593,1623,1686,2055,Primo Rolled Pancetta R/W,3264,2448,30,369
photo-89.jpg,2,1658,1692,1769,2057,Anchovie Fillets 730g,3264,2448,34,288
photo-89.jpg,3,1261,1289,516,629,100.00T,3264,2448,28,113
photo-89.jpg,1,1265,1292,789,867,25.00,3264,2448,27,78
photo-89.jpg,1,1266,1292,982,1001,4,3264,2448,26,19
photo-89.jpg,3,1326,1353,514,613,95.00T,3264,2448,27,99
photo-89.jpg,1,1328,1356,788,864,19.00,3264,2448,28,76
photo-89.jpg,1,1330,1356,983,999,5,3264,2448,26,16
photo-89.jpg,3,1391,1418,513,612,35.13T,3264,2448,27,99
photo-89.jpg,1,1394,1421,787,863,12.50,3264,2448,27,76
photo-89.jpg,1,1395,1421,983,1041,2.81,3264,2448,26,58
photo-89.jpg,3,1455,1483,512,610,26.00T,3264,2448,28,98
photo-89.jpg,1,1458,1486,786,863,26.00,3264,2448,28,77
photo-89.jpg,1,1460,1485,981,996,1,3264,2448,25,15
photo-89.jpg,3,1521,1549,510,623,140.00T,3264,2448,28,113
photo-89.jpg,1,1524,1551,784,860,17.50,3264,2448,27,76
photo-89.jpg,1,1525,1551,979,998,8,3264,2448,26,19
photo-89.jpg,3,1585,1613,508,607,44.10T,3264,2448,28,99
photo-89.jpg,1,1588,1616,782,858,18.00,3264,2448,28,76
photo-89.jpg,1,1589,1616,978,1038,2.45,3264,2448,27,60
photo-89.jpg,3,1652,1680,506,602,10.95T,3264,2448,28,96
photo-89.jpg,1,1654,1681,782,856,10.95,3264,2448,27,74
photo-89.jpg,1,1655,1681,978,992,1,3264,2448,26,14
photo-90.jpg,2,1254,1289,1586,2095,Primo Sliced Pepperoni (40mm) 2kg,3264,2448,35,509
photo-90.jpg,2,1322,1356,1593,2098,Thin Sliced Hungarian Salami 1.5kg,3264,2448,34,505
photo-90.jpg,2,1391,1424,1676,2095,Real Shredded Parmesan 2kg,3264,2448,33,419
photo-90.jpg,2,1460,1493,1741,2096,Zammit Diced Bacon 3kg,3264,2448,33,355
photo-90.jpg,3,1244,1271,497,611,100.00T,3264,2448,27,114
photo-90.jpg,1,1246,1273,778,856,25.00,3264,2448,27,78
photo-90.jpg,1,1249,1274,977,996,4,3264,2448,25,19
photo-90.jpg,1,1314,1341,777,854,19.00,3264,2448,27,77
photo-90.jpg,3,1311,1339,496,595,57.00T,3264,2448,28,99
photo-90.jpg,1,1316,1343,978,995,3,3264,2448,27,17
photo-90.jpg,3,1380,1408,494,594,26.00T,3264,2448,28,100
photo-90.jpg,1,1383,1410,776,855,26.00,3264,2448,27,79
photo-90.jpg,1,1385,1411,978,992,1,3264,2448,26,14
photo-90.jpg,3,1448,1476,494,607,140.00T,3264,2448,28,113
photo-90.jpg,1,1453,1479,977,994,8,3264,2448,26,17
photo-90.jpg,1,1451,1478,776,852,17.50,3264,2448,27,76
photo-91.jpg,2,1221,1272,1576,2123,Primo Sliced Pepperoni (40mm) 2kg,3264,2448,51,547
photo-91.jpg,2,1294,1345,1580,2124,Thin Sliced Hungarian Salami 1.5kg,3264,2448,51,544
photo-91.jpg,2,1370,1418,1668,2118,Real Shredded Parmesan 2kg,3264,2448,48,450
photo-91.jpg,2,1446,1491,1736,2117,Zammit Diced Bacon 3kg,3264,2448,45,381
photo-91.jpg,1,1193,1221,929,947,2,3264,2448,28,18
photo-91.jpg,1,1255,1287,709,793,19.00,3264,2448,32,84
photo-91.jpg,3,1242,1274,406,511,19.00T,3264,2448,32,105
photo-91.jpg,1,1265,1293,925,941,1,3264,2448,28,16
photo-91.jpg,1,1337,1365,920,939,2,3264,2448,28,19
photo-91.jpg,1,1328,1359,704,791,26.00,3264,2448,31,87
photo-91.jpg,3,1314,1348,402,510,52.00T,3264,2448,34,108
photo-91.jpg,1,1409,1438,917,936,8,3264,2448,29,19
photo-91.jpg,1,1399,1431,700,784,17.50,3264,2448,32,84
photo-91.jpg,3,1387,1420,397,521,140.00T,3264,2448,33,124
photo-92.jpg,2,1036,1062,1325,2120,BOWHCLPA2 5 BOWL WHITE CLASSIC PASTA 255MM FLINDERS,2448,3264,26,795
photo-92.jpg,2,1085,1105,1630,1920,FORKS TABLE MELROSE,2448,3264,20,290
photo-92.jpg,2,1124,1147,1524,1919,KNIVES TABLE MELROSE 17372,2448,3264,23,395
photo-92.jpg,2,1166,1189,1399,1919,PEPPER SHAKER CHELSEA TALL 80X35MM,2448,3264,23,520
photo-92.jpg,2,1211,1232,1582,1917,PLATE PIZZA WHITE 33CM,2448,3264,21,335
photo-92.jpg,2,1254,1274,1597,1919,SPOON DESSERT MELROSE,2448,3264,20,322
photo-92.jpg,2,1296,1317,1643,1918,SPOON SOUP MELROSE,2448,3264,21,275
photo-92.jpg,1,1010,1032,349,437,88.80,2448,3264,22,88
photo-92.jpg,1,1031,1053,1209,1241,12,2448,3264,22,32
photo-92.jpg,3,1085,1104,2011,2118,FOTAME,2448,3264,19,107
photo-92.jpg,1,1028,1049,1083,1114,12,2448,3264,21,31
photo-92.jpg,3,1017,1041,715,878,7.40 EACH,2448,3264,24,163
photo-92.jpg,3,1060,1084,695,894,10.98 DOZEN,2448,3264,24,199
photo-92.jpg,3,1104,1127,695,894,17.90 DOZEN,2448,3264,23,199
photo-92.jpg,3,1147,1170,714,876,2.55 EACH,2448,3264,23,162
photo-92.jpg,3,1190,1214,712,892,13.96 EACH,2448,3264,24,180
photo-92.jpg,3,1233,1256,693,892,10.28 DOZEN,2448,3264,23,199
photo-92.jpg,3,1276,1299,693,891,10.24 DOZEN,2448,3264,23,198
photo-92.jpg,1,1074,1094,1207,1221,1,2448,3264,20,14
photo-92.jpg,1,1070,1089,1081,1095,1,2448,3264,19,14
photo-92.jpg,1,1054,1074,348,436,10.98,2448,3264,20,88
photo-92.jpg,1,1097,1118,348,436,17.90,2448,3264,21,88
photo-92.jpg,1,1140,1160,347,435,30.60,2448,3264,20,88
photo-92.jpg,1,1183,1205,345,453,167.52,2448,3264,22,108
photo-92.jpg,1,1226,1247,344,433,10.28,2448,3264,21,89
photo-92.jpg,1,1269,1289,343,433,10.24,2448,3264,20,90
photo-92.jpg,1,1116,1136,1207,1220,1,2448,3264,20,13
photo-92.jpg,1,1112,1132,1080,1094,1,2448,3264,20,14
photo-92.jpg,3,1128,1148,2011,2117,KNTAME,2448,3264,20,106
photo-92.jpg,3,1170,1190,1973,2116,PESHCHTA,2448,3264,20,143
photo-92.jpg,3,1212,1233,1975,2114,PLPIWH33,2448,3264,21,139
photo-92.jpg,3,1255,1275,2009,2115,SPDEME,2448,3264,20,106
photo-92.jpg,3,1297,1317,2008,2115,SPSOME,2448,3264,20,107
photo-92.jpg,1,1159,1179,1207,1238,12,2448,3264,20,31
photo-92.jpg,1,1155,1176,1080,1112,12,2448,3264,21,32
photo-92.jpg,1,1201,1223,1206,1237,12,2448,3264,22,31
photo-92.jpg,1,1198,1219,1079,1111,12,2448,3264,21,32
photo-92.jpg,1,1243,1262,1205,1219,1,2448,3264,19,14
photo-92.jpg,1,1241,1261,1078,1092,1,2448,3264,20,14
photo-92.jpg,1,1285,1306,1205,1219,1,2448,3264,21,14
photo-92.jpg,1,1284,1303,1078,1092,1,2448,3264,19,14
photo-93.jpg,2,1090,1118,1520,2006,BRUSH PASTRY 38MM NATURAL 1 1/2,2448,3264,28,486
photo-93.jpg,2,1131,1157,1530,2006,LID STEAM PAN 1/6 W/HANDLE CAMBRO,2448,3264,26,476
photo-93.jpg,2,1169,1197,1456,2004,PEELER S/S VEGE U SHAPE/SPEED PEELER-,2448,3264,28,548
photo-93.jpg,2,1207,1237,1462,2004,SAUCE BOTTLE 1LT DECOR WITH RED LID ',2448,3264,30,542
photo-93.jpg,2,1251,1277,1600,2004,SPOON BASTING S/S 39CM PLAIN,2448,3264,26,404
photo-93.jpg,2,1289,1317,1512,2005,STEAM PAN 1/6 150MM.DEEP 175X161MM,2448,3264,28,493
photo-93.jpg,2,1327,1356,1540,2003,WHISK PIANO WIRE 45CM S/S SEALED,2448,3264,29,463
photo-93.jpg,1,1081,1100,1219,1234,1,2448,3264,19,15
photo-93.jpg,3,1070,1093,880,1031,1.57 EACH,2448,3264,23,151
photo-93.jpg,3,1109,1133,878,1031,3.95 EACH,2448,3264,24,153
photo-93.jpg,3,1149,1172,878,1030,3.36 EACH,2448,3264,23,152
photo-93.jpg,3,1188,1211,878,1030,4.14 EACH,2448,3264,23,152
photo-93.jpg,3,1228,1251,876,1028,2.06 EACH,2448,3264,23,152
photo-93.jpg,3,1267,1290,875,1027,7.88 EACH,2448,3264,23,152
photo-93.jpg,3,1307,1331,874,1025,9.74 EACH,2448,3264,24,151
photo-93.jpg,1,1059,1081,542,607,1.57,2448,3264,22,65
photo-93.jpg,1,1099,1119,540,625,47.40,2448,3264,20,85
photo-93.jpg,1,1138,1160,541,605,3.36,2448,3264,22,64
photo-93.jpg,1,1178,1199,538,622,24.84,2448,3264,21,84
photo-93.jpg,1,1218,1239,538,603,2.06,2448,3264,21,65
photo-93.jpg,1,1258,1279,535,618,94.56,2448,3264,21,83
photo-93.jpg,1,1298,1319,535,599,9.74,2448,3264,21,64
photo-93.jpg,1,1086,1103,1336,1350,1,2448,3264,17,14
photo-93.jpg,3,1102,1121,2094,2192,BRPA38,2448,3264,19,98
photo-93.jpg,3,1138,1162,2056,2192,LICA1/6H,2448,3264,24,136
photo-93.jpg,3,1181,1201,2078,2189,PE7900 .,2448,3264,20,111
photo-93.jpg,3,1221,1241,2074,2189,SAB0438,2448,3264,20,115
photo-93.jpg,3,1261,1280,2090,2190,SP3315,2448,3264,19,100
photo-93.jpg,3,1300,1320,2055,2189,STPA6150,2448,3264,20,134
photo-93.jpg,3,1341,1359,2089,2190,WHPI45,2448,3264,18,101
photo-93.jpg,1,1120,1139,1219,1250,12,2448,3264,19,31
photo-93.jpg,1,1125,1143,1336,1367,12,2448,3264,18,31
photo-93.jpg,1,1160,1179,1218,1232,1,2448,3264,19,14
photo-93.jpg,1,1164,1182,1335,1349,1,2448,3264,18,14
photo-93.jpg,1,1200,1219,1218,1231,6,2448,3264,19,13
photo-93.jpg,1,1204,1221,1334,1348,6,2448,3264,17,14
photo-93.jpg,1,1239,1258,1215,1230,1,2448,3264,19,15
photo-93.jpg,1,1244,1260,1333,1347,1,2448,3264,16,14
photo-93.jpg,1,1282,1302,1333,1363,12,2448,3264,20,30
photo-93.jpg,1,1278,1298,1215,1246,12,2448,3264,20,31
photo-93.jpg,1,1320,1339,1332,1345,1,2448,3264,19,13
photo-93.jpg,1,1317,1335,1214,1228,1,2448,3264,18,14
photo-94.jpg,2,1043,1061,1442,1846,PLATE RACK 50X50CM DISHWASHER,2448,3264,18,404
photo-94.jpg,2,1080,1099,1344,1848,SAOCE BOTTLE 1LT DECOR WITH RED LID,2448,3264,19,504
photo-94.jpg,2,1116,1139,1386,1848,STEAM PAN 1/1 20MM DEEP 530X325MM,2448,3264,23,462
photo-94.jpg,2,1155,1177,1373,1850,STEAM PAN 1/6 100MM DEEP 175X161MM,2448,3264,22,477
photo-94.jpg,3,1044,1063,755,917,39.59 EACH,2448,3264,19,162
photo-94.jpg,3,1082,1101,754,901,4.14 EACH,2448,3264,19,147
photo-94.jpg,3,1120,1139,754,916,10.65 EACH,2448,3264,19,162
photo-94.jpg,3,1158,1178,753,901,5.28 EACH,2448,3264,20,148
photo-94.jpg,1,1046,1065,429,508,79.18,2448,3264,19,79
photo-94.jpg,1,1084,1103,428,509,24.84,2448,3264,19,81
photo-94.jpg,1,1122,1142,427,508,63.90,2448,3264,20,81
photo-94.jpg,1,1161,1180,426,508,26.40,2448,3264,19,82
photo-94.jpg,1,1044,1062,1083,1097,2,2448,3264,18,14
photo-94.jpg,1,1043,1062,1198,1211,2,2448,3264,19,13
photo-94.jpg,3,1039,1057,1929,2027,PLRAPP,2448,3264,18,98
photo-94.jpg,3,1077,1096,1915,2028,SAB0438,2448,3264,19,113
photo-94.jpg,3,1116,1135,1915,2028,STPA125,2448,3264,19,113
photo-94.jpg,3,1154,1173,1898,2030,STFA6100,2448,3264,19,132
photo-94.jpg,1,1081,1100,1082,1097,6,2448,3264,19,15
photo-94.jpg,1,1080,1100,1197,1210,6,2448,3264,20,13
photo-94.jpg,1,1120,1138,1083,1096,6,2448,3264,18,13
photo-94.jpg,1,1119,1138,1197,1211,6,2448,3264,19,14
photo-94.jpg,1,1159,1177,1082,1097,5,2448,3264,18,15
photo-94.jpg,1,1158,1176,1197,1211,5,2448,3264,18,14
photo-95.jpg,2,1020,1047,1315,1861,FRYPAN ALUMINIUM 25CM (10:- PREMIER ',2448,3264,27,546
photo-95.jpg,2,1060,1088,1340,1862,FRYPAN ALUMINIUM 30CM (1..-) PREMIER,2448,3264,28,522
photo-95.jpg,2,1102,1127,1481,1864,PLATE PIZZA 23CM ALUM (5),2448,3264,25,383
photo-95.jpg,2,1143,1170,1371,1865,STEAM PAN 1/1 65MM DEEP 5‘0X325MM,2448,3264,27,494
photo-95.jpg,2,1185,1211,1373,1866,STEAM PAN 1/2 65MM DEEP 32r.X265MM,2448,3264,26,493
photo-95.jpg,3,1014,1035,1916,2054,FRPA6125,2448,3264,21,138
photo-95.jpg,3,1055,1076,1917,2056,FRPA6130,2448,3264,21,139
photo-95.jpg,3,1096,1118,1918,2055,PLPI6209,2448,3264,22,137
photo-95.jpg,3,1137,1160,1937,2058,STPA165,2448,3264,23,121
photo-95.jpg,3,1179,1201,1939,2059,STPA265,2448,3264,22,120
photo-95.jpg,3,1037,1060,690,863,14.70 EACH,2448,3264,23,173
photo-95.jpg,3,1078,1101,691,864,19.69 EACH,2448,3264,23,173
photo-95.jpg,3,1119,1142,691,848,1.88 EACH,2448,3264,23,157
photo-95.jpg,3,1159,1183,692,866,11.88 EACH,2448,3264,24,174
photo-95.jpg,3,1201,1224,693,849,7.13 EACH,2448,3264,23,156
photo-95.jpg,1,1031,1051,1165,1178,8,2448,3264,20,13
photo-95.jpg,1,1034,1053,1043,1056,8,2448,3264,19,13
photo-95.jpg,1,1045,1065,338,441,117.60,2448,3264,20,103
photo-95.jpg,3,1085,1106,340,458,-118.14,2448,3264,21,118
photo-95.jpg,1,1127,1147,340,426,45.12,2448,3264,20,86
photo-95.jpg,1,1167,1188,341,426,23.76,2448,3264,21,85
photo-95.jpg,1,1208,1230,342,427,28.52,2448,3264,22,85
photo-95.jpg,3,1072,1092,1166,1196,-6,2448,3264,20,30
photo-95.jpg,3,1075,1094,1044,1073,-6,2448,3264,19,29
photo-95.jpg,1,1116,1135,1044,1077,24,2448,3264,19,33
photo-95.jpg,3,1113,1133,1166,1198,>4,2448,3264,20,32
photo-95.jpg,1,1157,1176,1045,1059,2,2448,3264,19,14
photo-95.jpg,1,1155,1174,1168,1182,2,2448,3264,19,14
photo-95.jpg,1,1196,1215,1169,1183,4,2448,3264,19,14
photo-95.jpg,1,1199,1217,1046,1060,4,2448,3264,18,14
photo-96.jpg,2,1034,1053,1585,1988,FRYPAN BLUE STEEL 360X62MM,2448,3264,19,403
photo-96.jpg,2,1076,1096,1577,1988,PLATE PIZZA 38CM ALUM (15),2448,3264,20,411
photo-96.jpg,2,1115,1139,1369,1989,STOCKPOT ALUMINIUM PREMIER 16L 280X255MM,2448,3264,24,620
photo-96.jpg,2,1159,1181,1369,1989,STOCKPOT ALUMINIUM PREMIER 60L 440X405MM,2448,3264,22,620
photo-96.jpg,2,1202,1225,1384,1989,THERMOMETER FR/FREEZER S/S -28.9+26.7.C,2448,3264,23,605
photo-96.jpg,1,1021,1042,409,498,80.00,2448,3264,21,89
photo-96.jpg,1,1065,1086,409,517,129.30,2448,3264,21,108
photo-96.jpg,1,1106,1127,408,498,75.00,2448,3264,21,90
photo-96.jpg,1,1150,1170,408,497,87.50,2448,3264,20,89
photo-96.jpg,1,1193,1214,407,496,14.38,2448,3264,21,89
photo-96.jpg,1,1029,1048,1142,1157,2,2448,3264,19,15
photo-96.jpg,3,1026,1047,775,956,40.00 EACH,2448,3264,21,181
photo-96.jpg,3,1069,1090,775,938,4.31 EACH,2448,3264,21,163
photo-96.jpg,3,1112,1132,774,956,37.50 EACH,2448,3264,20,182
photo-96.jpg,3,1154,1175,774,955,87.50 EACH,2448,3264,21,181
photo-96.jpg,3,1196,1217,773,936,7.19 EACH,2448,3264,21,163
photo-96.jpg,1,1030,1050,1269,1284,2,2448,3264,20,15
photo-96.jpg,3,1032,1052,2040,2189,FRPA3836-,2448,3264,20,149
photo-96.jpg,3,1074,1095,2045,2188,PLPI6215,2448,3264,21,143
photo-96.jpg,3,1117,1139,2045,2189,STPOPR16,2448,3264,22,144
photo-96.jpg,3,1160,1181,2045,2189,STPOPR60,2448,3264,21,144
photo-96.jpg,3,1203,1223,2081,2190,TH5386,2448,3264,20,109
photo-96.jpg,1,1071,1091,1141,1174,30,2448,3264,20,33
photo-96.jpg,1,1071,1092,1268,1301,30,2448,3264,21,33
photo-96.jpg,1,1114,1134,1142,1156,2,2448,3264,20,14
photo-96.jpg,1,1115,1135,1268,1283,2,2448,3264,20,15
photo-96.jpg,1,1156,1177,1140,1156,1,2448,3264,21,16
photo-96.jpg,1,1157,1177,1268,1282,1,2448,3264,20,14
photo-96.jpg,1,1198,1219,1140,1155,2,2448,3264,21,15
photo-96.jpg,1,1198,1218,1030,1045,1,2448,3264,20,15
photo-96.jpg,1,1200,1220,1267,1282,3,2448,3264,20,15
photo-97.jpg,2,1023,1044,1518,2022,BOWL MIXING S/STEEL 13LT 450X125MM,2448,3264,21,504
photo-97.jpg,2,1063,1085,1489,2022,BOWL MIXING S/STEEL 17.5LT 480X140MM,2448,3264,22,533
photo-97.jpg,2,1104,1128,1636,2213,GRSS190X23 GRATER 4 SIDED S/S 19X23CM,2448,3264,24,577
photo-97.jpg,2,1144,1168,1568,2021,LADLE S/S 180ML ONE-PIECE (60Z),2448,3264,24,453
photo-97.jpg,2,1184,1208,1517,2020,STEAM PAN 1/6 100MM DEEP 175X161MM,2448,3264,24,503
photo-97.jpg,2,1225,1248,1516,2020,STEAM PAN 1/6 150MM DEEP 175X161MM,2448,3264,23,504
photo-97.jpg,3,1009,1031,867,1038,14.70 EACH,2448,3264,22,171
photo-97.jpg,3,1050,1071,867,1037,18.03 EACH,2448,3264,21,170
photo-97.jpg,3,1091,1111,866,1019,8.82 EACH,2448,3264,20,153
photo-97.jpg,3,1131,1151,865,1019,2.81 EACH,2448,3264,20,154
photo-97.jpg,3,1172,1192,865,1017,5.28 EACH,2448,3264,20,152
photo-97.jpg,3,1212,1233,864,1017,7.88 EACH,2448,3264,21,153
photo-97.jpg,1,1005,1023,522,605,14.70,2448,3264,18,83
photo-97.jpg,1,1045,1064,522,604,18.03,2448,3264,19,82
photo-97.jpg,1,1086,1104,521,586,8.82,2448,3264,18,65
photo-97.jpg,1,1126,1145,520,586,2.81,2448,3264,19,66
photo-97.jpg,1,1167,1185,519,602,26.40,2448,3264,18,83
photo-97.jpg,1,1208,1226,518,600,39.40,2448,3264,18,82
photo-97.jpg,3,1026,1045,2110,2214,B07217,2448,3264,19,104
photo-97.jpg,3,1066,1087,2111,2214,B07220,2448,3264,21,103
photo-97.jpg,1,1016,1034,1213,1227,1,2448,3264,18,14
photo-97.jpg,1,1017,1035,1334,1348,1,2448,3264,18,14
photo-97.jpg,1,1056,1074,1213,1227,1,2448,3264,18,14
photo-97.jpg,1,1058,1076,1333,1347,1,2448,3264,18,14
photo-97.jpg,1,1097,1115,1212,1226,1,2448,3264,18,14
photo-97.jpg,3,1149,1168,2092,2214,LA36006,2448,3264,19,122
photo-97.jpg,3,1189,1209,2076,2212,STPA610C,2448,3264,20,136
photo-97.jpg,3,1230,1250,2074,2212,STPA6150,2448,3264,20,138
photo-97.jpg,1,1098,1117,1333,1346,1,2448,3264,19,13
photo-97.jpg,1,1136,1153,1108,1122,1,2448,3264,17,14
photo-97.jpg,1,1138,1155,1212,1226,1,2448,3264,17,14
photo-97.jpg,1,1138,1157,1333,1348,2,2448,3264,19,15
photo-97.jpg,1,1177,1196,1212,1225,5,2448,3264,19,13
photo-97.jpg,1,1180,1198,1332,1345,5,2448,3264,18,13
photo-97.jpg,1,1217,1234,1107,1121,7,2448,3264,17,14
photo-97.jpg,1,1218,1237,1211,1224,5,2448,3264,19,13
photo-97.jpg,1,1219,1241,1332,1362,12,2448,3264,22,30
photo-98.jpg,2,1064,1086,1517,1999,BIN GARBAGE 76LT PLASTIC WITH LID,2448,3264,22,482
photo-98.jpg,2,1105,1127,1475,2001,BIN INGREDIENT 81LTR LOCKING CASTORS,2448,3264,22,526
photo-98.jpg,2,1145,1168,1487,2000,BOWL MIXING S/STEEL 4.2LT 300X100MM,2448,3264,23,513
photo-98.jpg,2,1186,1208,1487,2001,BOWL MIXING S/STEEL 6.0LT 335X110MM,2448,3264,22,514
photo-98.jpg,2,1224,1248,1506,2001,BRUSH PASTRY 38MM NATURAL 1 1/2,2448,3264,24,495
photo-98.jpg,2,1266,1288,1460,2000,CAN OPENER BONZER WITH CLAMP & SCREWS,2448,3264,22,540
photo-98.jpg,2,1307,1328,1488,2001,COLANDER ALUMINIUM H.D. 13 LT 35 CM,2448,3264,21,513
photo-98.jpg,2,1347,1369,1415,2189,COMRCR3.15 CONTAINER MRS CROCKET SQUARE 3.15LT f-LID,2448,3264,22,774
photo-98.jpg,2,1387,1409,1414,2001,CONTAINER MRS CROCKET SQUARE 4.5LT £ LID,2448,3264,22,587
photo-98.jpg,2,1427,1449,1414,2001,CRATE IH060 N07 STAKANESTA 645X413X21GMM,2448,3264,22,587
photo-98.jpg,2,1470,1490,1575,2001,CRATE IH089 N04 430X323X17/*!M,2448,3264,20,426
photo-98.jpg,2,1552,1573,1619,2003,CUTTING BOARD 380X51 OX' 3MM,2448,3264,21,384
photo-98.jpg,2,1511,1531,1516,2001,"CUTTING BOARD 380X510X13MM : /,IOW",2448,3264,20,485
photo-98.jpg,2,1594,1614,1533,2003,CUTTING BOARD 380X510X13MM GREEN,2448,3264,20,470
photo-98.jpg,2,1635,1655,1546,2002,CUTTING BOARD 380X510X13MX BLUE,2448,3264,20,456
photo-98.jpg,2,1677,1697,1561,2002,CUTTING BOARD 380X51QX13MM RED,2448,3264,20,441
photo-98.jpg,2,1718,1738,1519,2003,CUTTING BOARD 450X610X13MM 04322,2448,3264,20,484
photo-98.jpg,2,1757,1781,1610,2003,DOCKET HOLDER S/S TKN 1100,2448,3264,24,393
photo-98.jpg,2,1798,1821,1487,2004,FRYPAN ALUMINIUM 30CM (12) PREMIER,2448,3264,23,517
photo-98.jpg,2,1842,1861,1620,2004,FRYPAN BLUE STEEL 360X62MM,2448,3264,19,384
photo-98.jpg,2,1882,1903,1592,2007,GRATER MICROPLANE FINE 35002,2448,3264,21,415
photo-98.jpg,2,1922,1945,1591,2004,IPOON BASTING S/S 29CM PLAIN,2448,3264,23,413
photo-98.jpg,2,1966,1985,1620,2006,JUG MEASURING THERMO 5.0LT,2448,3264,19,386
photo-98.jpg,2,2007,2027,1592,2007,JUG MEASURING THERMO 3 LITRE,2448,3264,20,415
photo-98.jpg,2,2047,2071,1553,2007,LADLE S/S 120ML ONE PIECE (40Z),2448,3264,24,454
photo-98.jpg,2,2091,2111,1568,2008,LID IH014 FOR N04 CRATE(IH089),2448,3264,20,440
photo-98.jpg,2,2131,2154,1531,2008,LID IH052 P/PROOF FOR 7/10/15CRT,2448,3264,23,477
photo-98.jpg,2,2174,2196,1517,2009,MEASURING CUP SET S/STEEL 4 PIECE,2448,3264,22,492
photo-98.jpg,2,2218,2238,1657,2008,PADDLE WOODEN 60CM (24),2448,3264,20,351
photo-98.jpg,2,2261,2279,1487,2008,PASTRY DOCKER WIDTH OF ROLLER 115MM,2448,3264,18,521
photo-98.jpg,2,2301,2323,1637,2009,PEELER S/S VEGE U SHAPE,2448,3264,22,372
photo-98.jpg,2,2344,2364,1533,2011,PEPPER MILL MAHOGONY 3 0CM WOODEN,2448,3264,20,478
photo-98.jpg,2,2385,2408,1625,2012,PIZZA CUTTER ROCKER .S/S 4r,2448,3264,23,387
photo-98.jpg,2,2430,2449,1608,2012,PIZZA PEEL ALU SHORT NOODLN,2448,3264,19,404
photo-98.jpg,2,2471,2492,1413,2013,PIZZA RACK CHROME FREE aW TtfG HOLDS 19,2448,3264,21,600
photo-98.jpg,3,1053,1128,1175,1239,a,2448,3264,75,64
photo-98.jpg,3,1055,1075,852,1024,20.91 EACH,2448,3264,20,172
photo-98.jpg,3,1096,1116,851,1041,215.00 EACH,2448,3264,20,190
photo-98.jpg,3,1135,1156,850,1006,2.75 EACH,2448,3264,21,156
photo-98.jpg,3,1176,1197,850,1004,5.50 EACH,2448,3264,21,154
photo-98.jpg,3,1217,1237,849,1004,1.57 EACH,2448,3264,20,155
photo-98.jpg,3,1257,1278,849,1039,112.10 EACH,2448,3264,21,190
photo-98.jpg,3,1297,1318,849,1022,33.00 EACH,2448,3264,21,173
photo-98.jpg,3,1338,1359,849,1004,1.75 EACH,2448,3264,21,155
photo-98.jpg,3,1379,1399,847,1004,2.19 EACH,2448,3264,20,157
photo-98.jpg,3,1050,1069,480,589,62.73 v,2448,3264,19,109
photo-98.jpg,3,1071,1117,474,607,215.00^,2448,3264,46,133
photo-98.jpg,3,1118,1151,453,588,11.00/‘,2448,3264,33,135
photo-98.jpg,3,1159,1192,450,587,11.001/',2448,3264,33,137
photo-98.jpg,3,1202,1232,453,570,3.14i/ ',2448,3264,30,117
photo-98.jpg,1,1061,1080,1319,1333,3,2448,3264,19,14
photo-98.jpg,3,1067,1086,2085,2187,BIGA73,2448,3264,19,102
photo-98.jpg,3,1108,1127,2086,2188,BITN81,2448,3264,19,102
photo-98.jpg,3,1148,1168,2086,2188,BO7205,2448,3264,20,102
photo-98.jpg,3,1188,1209,2086,2188,B07>08,2448,3264,21,102
photo-98.jpg,3,1218,1264,2088,2195,|'RPA38,2448,3264,46,107
photo-98.jpg,3,1267,1289,2053,2196,taopso'^,2448,3264,22,143
photo-98.jpg,3,1309,1329,2053,2189,COALHD35,2448,3264,20,136
photo-98.jpg,1,1101,1120,1318,1333,1,2448,3264,19,15
photo-98.jpg,1,1142,1160,1318,1333,4,2448,3264,18,15
photo-98.jpg,1,1182,1201,1319,1333,2,2448,3264,19,14
photo-98.jpg,1,1222,1241,1319,1333,2,2448,3264,19,14
photo-98.jpg,1,1252,1273,555,603,112,2448,3264,21,48
photo-98.jpg,1,1252,1329,1176,1232,8,2448,3264,77,56
photo-98.jpg,1,1263,1282,1318,1333,1,2448,3264,19,15
photo-98.jpg,1,1292,1314,518,587,33.0,2448,3264,22,69
photo-98.jpg,3,1318,1354,451,586,21.004/*,2448,3264,36,135
photo-98.jpg,1,1303,1322,1319,1333,1,2448,3264,19,14
photo-98.jpg,3,1331,1371,1182,1243,<s>,2448,3264,40,61
photo-98.jpg,1,1343,1362,1319,1349,12,2448,3264,19,30
photo-98.jpg,3,1389,1410,2034,2188,COMRCR4.5,2448,3264,21,154
photo-98.jpg,3,1430,1450,2070,2189,CRIH060,2448,3264,20,119
photo-98.jpg,3,1470,1491,2070,2189,CRIH089,2448,3264,21,119
photo-98.jpg,1,1381,1402,1094,1124,12,2448,3264,21,30
photo-98.jpg,1,1383,1405,1196,1211,0,2448,3264,22,15
photo-98.jpg,3,1374,1394,499,544,.00,2448,3264,20,45
photo-98.jpg,1,1383,1403,1318,1349,12,2448,3264,20,31
photo-98.jpg,3,1410,1444,1189,1234,o,2448,3264,34,45
photo-98.jpg,3,1420,1440,847,1021,18.78 EACH,2448,3264,20,174
photo-98.jpg,3,1461,1482,847,1003,8.74 EACH,2448,3264,21,156
photo-98.jpg,3,1501,1523,848,1020,11.00 EACH,2448,3264,22,172
photo-98.jpg,3,1544,1565,846,1020,11.00 EACH,2448,3264,21,174
photo-98.jpg,3,1586,1608,846,1020,11.00 EACH,2448,3264,22,174
photo-98.jpg,3,1627,1650,846,1020,11.00 EACH,2448,3264,23,174
photo-98.jpg,3,1669,1691,847,1019,11.00 EACH,2448,3264,22,172
photo-98.jpg,1,1415,1436,499,584,18.78,2448,3264,21,85
photo-98.jpg,3,1452,1476,460,584,26.22k/,2448,3264,24,124
photo-98.jpg,1,1425,1444,1318,1332,1,2448,3264,19,14
photo-98.jpg,3,1451,1492,1143,1237,<P •,2448,3264,41,94
photo-98.jpg,1,1464,1485,1318,1332,3,2448,3264,21,14
photo-98.jpg,3,1496,1532,1180,1226,<P,2448,3264,36,46
photo-98.jpg,1,1496,1518,498,584,11.00,2448,3264,22,86
photo-98.jpg,3,1532,1561,458,583,11.00/*,2448,3264,29,125
photo-98.jpg,1,1506,1525,1317,1332,1,2448,3264,19,15
photo-98.jpg,3,1511,1531,2036,2190,CUBOYE380,2448,3264,20,154
photo-98.jpg,3,1551,1575,2054,2190,CUB04321,2448,3264,24,136
photo-98.jpg,3,1594,1615,2037,2191,CUBOGR380,2448,3264,21,154
photo-98.jpg,3,1636,1656,2037,2190,CUBOBL380,2448,3264,20,153
photo-98.jpg,3,1677,1697,2037,2192,CUBORE380,2448,3264,20,155
photo-98.jpg,3,1717,1739,2056,2193,CUB04322,2448,3264,22,137
photo-98.jpg,3,1759,1780,2039,2194,DOHOTKllO,2448,3264,21,155
photo-98.jpg,3,1801,1822,2057,2194,FRPA6130,2448,3264,21,137
photo-98.jpg,3,1841,1863,2058,2195,FRPA3836,2448,3264,22,137
photo-98.jpg,3,1883,1905,2093,2197,GRMIFI,2448,3264,22,104
photo-98.jpg,3,1925,1945,2094,2197,SP3311,2448,3264,20,103
photo-98.jpg,3,1966,1988,2077,2198,JUMETH5,2448,3264,22,121
photo-98.jpg,3,2008,2028,2078,2145,ETH3,2448,3264,20,67
photo-98.jpg,3,2049,2071,2078,2200,LA36004,2448,3264,22,122
photo-98.jpg,3,2092,2113,2079,2200,t_ii:(014,2448,3264,21,121
photo-98.jpg,3,2134,2155,2079,2191,jIIH052,2448,3264,21,112
photo-98.jpg,3,2176,2197,2114,2201,MESE4,2448,3264,21,87
photo-98.jpg,3,2218,2239,2063,2200,PAW03424,2448,3264,21,137
photo-98.jpg,3,2261,2282,2109,2202,PADO .,2448,3264,21,93
photo-98.jpg,3,2301,2324,2099,2203,PE7900,2448,3264,23,104
photo-98.jpg,3,2344,2366,2066,2205,PEMIMA30,2448,3264,22,139
photo-98.jpg,3,2386,2409,2099,2206,PICURO,2448,3264,23,107
photo-98.jpg,3,2430,2451,2136,2206,PIPE,2448,3264,21,70
photo-98.jpg,3,1536,1578,1181,1225,<9,2448,3264,42,44
photo-98.jpg,1,1548,1568,1318,1332,1,2448,3264,20,14
photo-98.jpg,3,1579,1616,1184,1223,O,2448,3264,37,39
photo-98.jpg,3,1571,1603,445,582,11.00/',2448,3264,32,137
photo-98.jpg,1,1590,1610,1318,1332,1,2448,3264,20,14
photo-98.jpg,3,1610,1645,459,582,11.00/*,2448,3264,35,123
photo-98.jpg,1,1630,1651,1193,1211,1,2448,3264,21,18
photo-98.jpg,1,1632,1652,1317,1333,1,2448,3264,20,16
photo-98.jpg,1,1665,1687,496,581,11.00,2448,3264,22,85
photo-98.jpg,3,1708,1729,498,581,14.5l,2448,3264,21,83
photo-98.jpg,3,1736,1770,441,581,24.40/'',2448,3264,34,140
photo-98.jpg,3,1778,1814,455,598,157.52a/,2448,3264,36,143
photo-98.jpg,3,1832,1853,480,539,.oo-,2448,3264,21,59
photo-98.jpg,3,1869,1896,452,579,25.001/,2448,3264,27,127
photo-98.jpg,3,1898,1937,452,559,2.52^/,2448,3264,39,107
photo-98.jpg,1,1673,1693,1317,1332,1,2448,3264,20,15
photo-98.jpg,3,1712,1733,845,1019,14.50 EACH,2448,3264,21,174
photo-98.jpg,3,1715,1738,1192,1210,"1,",2448,3264,23,18
photo-98.jpg,1,1715,1735,1318,1331,1,2448,3264,20,13
photo-98.jpg,3,1755,1773,845,1018,12.20 EACH,2448,3264,18,173
photo-98.jpg,3,1752,1779,1165,1211,2)-*,2448,3264,27,46
photo-98.jpg,1,1756,1776,1318,1332,2,2448,3264,20,14
photo-98.jpg,3,1795,1816,845,1018,19.69 EACH,2448,3264,21,173
photo-98.jpg,3,1836,1857,844,1018,40.00 EACH,2448,3264,21,174
photo-98.jpg,3,1878,1899,843,1018,25.00 EACH,2448,3264,21,175
photo-98.jpg,3,1920,1940,843,999,1.26 EACH,2448,3264,20,156
photo-98.jpg,3,1961,1981,843,999,7.32 EACH,2448,3264,20,156
photo-98.jpg,1,1797,1818,1318,1332,8,2448,3264,21,14
photo-98.jpg,1,1837,1859,1091,1105,2,2448,3264,22,14
photo-98.jpg,1,1838,1858,1195,1208,0,2448,3264,20,13
photo-98.jpg,1,1838,1859,1318,1331,2,2448,3264,21,13
photo-98.jpg,3,1870,1910,1173,1235,<D,2448,3264,40,62
photo-98.jpg,1,1880,1900,1316,1332,1,2448,3264,20,16
photo-98.jpg,1,1921,1941,1316,1331,2,2448,3264,20,15
photo-98.jpg,1,1962,1982,1316,1330,1,2448,3264,20,14
photo-98.jpg,1,1958,1979,490,559,7.32,2448,3264,21,69
photo-98.jpg,3,1987,2021,431,557,5.49/*,2448,3264,34,126
photo-98.jpg,3,2027,2064,435,575,11.40*/’,2448,3264,37,140
photo-98.jpg,3,2002,2023,841,998,5.49 EACH,2448,3264,21,157
photo-98.jpg,3,2044,2065,841,999,2.28 EACH,2448,3264,21,158
photo-98.jpg,3,2086,2107,841,1015,12.71 EACH,2448,3264,21,174
photo-98.jpg,3,2129,2150,839,1015,14.88 EACH,2448,3264,21,176
photo-98.jpg,3,2171,2193,837,997,4.60 EACH,2448,3264,22,160
photo-98.jpg,3,2214,2235,838,996,5.79 EACH,2448,3264,21,158
photo-98.jpg,3,2256,2277,837,1014,21.25 EACH,2448,3264,21,177
photo-98.jpg,3,2299,2319,837,994,3.36 EACH,2448,3264,20,157
photo-98.jpg,3,2341,2362,836,1012,13.00 EACH,2448,3264,21,176
photo-98.jpg,3,2382,2405,834,1013,24.10 EACH,2448,3264,23,179
photo-98.jpg,3,2425,2448,834,1012,27.28 EACH,2448,3264,23,178
photo-98.jpg,3,2468,2490,834,1010,50.46 EACH,2448,3264,22,176
photo-98.jpg,1,2004,2024,1316,1331,1,2448,3264,20,15
photo-98.jpg,3,2034,2074,1175,1231,<S>,2448,3264,40,56
photo-98.jpg,1,2046,2066,1316,1330,5,2448,3264,20,14
photo-98.jpg,3,2071,2106,436,573,38.13-/”,2448,3264,35,137
photo-98.jpg,1,2088,2109,1194,1209,3,2448,3264,21,15
photo-98.jpg,1,2088,2108,1317,1330,3,2448,3264,20,13
photo-98.jpg,3,2121,2158,435,573,14.88/^,2448,3264,37,138
photo-98.jpg,3,2154,2209,391,554,"4.60V/^,",2448,3264,55,163
photo-98.jpg,3,2206,2235,444,552,5.791/,2448,3264,29,108
photo-98.jpg,3,2250,2277,442,569,21.2 5v/,2448,3264,27,127
photo-98.jpg,3,2298,2323,427,550,6.72 WT,2448,3264,25,123
photo-98.jpg,1,2340,2363,480,567,13.00,2448,3264,23,87
photo-98.jpg,3,2372,2407,423,567,24.10V/*,2448,3264,35,144
photo-98.jpg,3,2419,2468,419,565,27.281^:,2448,3264,49,146
photo-98.jpg,3,2448,2492,436,581,100.92^,2448,3264,44,145
photo-98.jpg,1,2130,2151,1314,1330,1,2448,3264,21,16
photo-98.jpg,1,2173,2193,1192,1206,1,2448,3264,20,14
photo-98.jpg,1,2172,2193,1314,1329,1,2448,3264,21,15
photo-98.jpg,1,2214,2235,1315,1329,1,2448,3264,21,14
photo-98.jpg,1,2256,2277,1189,1206,1,2448,3264,21,17
photo-98.jpg,1,2257,2277,1314,1329,1,2448,3264,20,15
photo-98.jpg,1,2299,2319,1193,1207,2,2448,3264,20,14
photo-98.jpg,1,2300,2318,1315,1329,2,2448,3264,18,14
photo-98.jpg,1,2342,2360,1191,1206,1,2448,3264,18,15
photo-98.jpg,1,2342,2361,1314,1329,1,2448,3264,19,15
photo-98.jpg,1,2369,2458,1172,1234,8,2448,3264,89,62
photo-98.jpg,1,2383,2403,1313,1329,1,2448,3264,20,16
photo-98.jpg,1,2425,2445,1312,1327,1,2448,3264,20,15
photo-98.jpg,3,2453,2507,1175,1228,<0,2448,3264,54,53
photo-98.jpg,1,2467,2489,1085,1099,2,2448,3264,22,14
photo-98.jpg,1,2469,2488,1315,1328,4,2448,3264,19,13
photo-98.jpg,3,2472,2495,2105,2209,PIRA18,2448,3264,23,104
photo-99.jpg,2,989,1012,1563,1958,PLATE PIZZA 30CM ALUM (12),2448,3264,23,395
photo-99.jpg,2,1029,1053,1564,1959,PLATE PIZZA 38CM ALUM (15),2448,3264,24,395
photo-99.jpg,2,1070,1096,1381,1961,POTATO MASHER HD 30CM (12) WOOD HANDLE,2448,3264,26,580
photo-99.jpg,2,1112,1134,1576,1963,RACK FOR 10 CUTTING BOARDS,2448,3264,22,387
photo-99.jpg,2,1152,1179,1388,1964,SALT DREDGE 285ML (75MM DIAM/95MM HIGH),2448,3264,27,576
photo-99.jpg,2,1193,1219,1444,1965,SAUCE BOTTLE 980ML WHITE WIDE MOUTH,2448,3264,26,521
photo-99.jpg,2,1235,1260,1370,1966,SAUCEPAN ALUMINIUM PREMIER 10 LT 30X15CM,2448,3264,25,596
photo-99.jpg,2,1275,1301,1369,1967,SAUCEPAN ALUMINIUM PREMIER j.5LT 22X1104,2448,3264,26,598
photo-99.jpg,2,1316,1335,1761,1968,SCALES KITCHEN,2448,3264,19,207
photo-99.jpg,2,1357,1384,1408,1969,SCOOP ROUND BOTTOM 23X12CM ALUM (380Z),2448,3264,27,561
photo-99.jpg,2,1398,1422,1597,1969,SCRAPER BOWL RUBBER BLADE,2448,3264,24,372
photo-99.jpg,2,1440,1465,1462,1971,SCRAPER DOUGH 150X74MM PLASTIC HDL,2448,3264,25,509
photo-99.jpg,2,1482,1509,1388,1971,SCRAPER GRIDDLE 105X95MM V CD HDL 260MM,2448,3264,27,583
photo-99.jpg,2,1523,1549,1479,1971,SPOON BASTING S/S 29CM PERFORATED,2448,3264,26,492
photo-99.jpg,2,1564,1593,1376,1973,SPOON MEASURING SET STAINLESS STEEL 4PCE,2448,3264,29,597
photo-99.jpg,2,1606,1632,1555,1973,SPOON TEA ATLANTIS/MELBOURNE,2448,3264,26,418
photo-99.jpg,2,1648,1678,1376,1973,SPOON WOODEN MIXING 45CM (10) BEECHWOOD,2448,3264,30,597
photo-99.jpg,2,1690,1717,1482,1975,STEAM PAN 1/1 20MM DEEP 530X325MM,2448,3264,27,493
photo-99.jpg,2,1732,1756,1604,1977,STEAM PAN 1/3 LID 321X175,2448,3264,24,373
photo-99.jpg,2,1774,1802,1468,1978,STEAM PAN 1/6 100MM DEEP 175X161MM,2448,3264,28,510
photo-99.jpg,2,1816,1841,1606,1979,STEAM PAN 1/6 LID 173X160,2448,3264,25,373
photo-99.jpg,2,1858,1886,1470,1981,STEAM PAN 1/9 100MM DEEP 176X108MM,2448,3264,28,511
photo-99.jpg,2,1900,1925,1608,1982,STEAM PAN 1/9 LID 176X108,2448,3264,25,374
photo-99.jpg,2,1942,1972,1381,1983,STOCKPOT ALUMINIUM PREMIER 16L 280X255MM,2448,3264,30,602
photo-99.jpg,2,1984,2014,1382,1984,STOCKPOT ALUMINIUM PREMIER 60L 440X405MM,2448,3264,30,602
photo-99.jpg,2,2026,2053,1505,1986,STRAINER CONICAL S/S 23CM COURSE,2448,3264,27,481
photo-99.jpg,2,2068,2099,1385,1988,THERMOMETER DIGITAL PKT TEMP PRO W'PriOOF,2448,3264,31,603
photo-99.jpg,2,2109,2139,1419,1988,THERMOMETER FR/FREEZER S/S - 28.9+?i . 7 .,2448,3264,30,569
photo-99.jpg,2,2151,2183,1415,1989,TONG X/H/D DELUXE S/S 16 •'°CM S6 CLIP,2448,3264,32,574
photo-99.jpg,2,2194,2220,1632,1991,TONG X/H/D DELUXE S/S 9,2448,3264,26,359
photo-99.jpg,2,2237,2268,1403,1993,TROLLEY GASTRONORM PANS 17 TPT x W/IOCKS,2448,3264,31,590
photo-99.jpg,2,2280,2308,1509,1994,WHISK FRENCH H/D 50CM S/S SEALED,2448,3264,28,485
photo-99.jpg,3,966,1004,2014,2184,f1?LPI6212,2448,3264,38,170
photo-99.jpg,3,1022,1043,2015,2151,PLPI6215,2448,3264,21,136
photo-99.jpg,3,1000,1022,788,945,3.06 EACH,2448,3264,22,157
photo-99.jpg,3,1042,1063,789,946,4.31 EACH,2448,3264,21,157
photo-99.jpg,3,1083,1106,789,946,6.66 EACH,2448,3264,23,157
photo-99.jpg,3,1124,1146,789,965,18.58 EACH,2448,3264,22,176
photo-99.jpg,3,1166,1187,790,949,4.16 EACH,2448,3264,21,159
photo-99.jpg,3,1207,1228,791,948,2.00 EACH,2448,3264,21,157
photo-99.jpg,3,1248,1269,792,966,31.92 EACH,2448,3264,21,174
photo-99.jpg,3,1289,1311,792,967,18.43 EACH,2448,3264,22,175
photo-99.jpg,3,1330,1352,792,967,37.50 EACH,2448,3264,22,175
photo-99.jpg,3,1372,1393,793,968,11.30 EACH,2448,3264,21,175
photo-99.jpg,3,1414,1435,794,952,4.13 EACH,2448,3264,21,158
photo-99.jpg,3,1455,1477,794,953,3.58 EACH,2448,3264,22,159
photo-99.jpg,3,1498,1520,795,952,5.00 EACH,2448,3264,22,157
photo-99.jpg,3,1540,1562,796,953,1.26 EACH,2448,3264,22,157
photo-99.jpg,3,1582,1604,796,954,4.10 EACH,2448,3264,22,158
photo-99.jpg,3,1624,1647,780,954,3.65 BOX12,2448,3264,23,174
photo-99.jpg,3,1667,1689,797,954,1.75 EACH,2448,3264,22,157
photo-99.jpg,3,1709,1731,797,972,10.65 EACH,2448,3264,22,175
photo-99.jpg,3,1751,1775,798,956,6.95 EACH,2448,3264,24,158
photo-99.jpg,3,1794,1817,797,956,5.28 EACH,2448,3264,23,159
photo-99.jpg,3,1837,1859,798,957,4.36 EACH,2448,3264,22,159
photo-99.jpg,3,1880,1902,798,957,5.49 EACH,2448,3264,22,159
photo-99.jpg,3,1921,1944,800,958,3.92 EACH,2448,3264,23,158
photo-99.jpg,3,1964,1986,799,977,37.50 EACH,2448,3264,22,178
photo-99.jpg,3,2006,2028,799,976,87.50 EACH,2448,3264,22,177
photo-99.jpg,3,2048,2070,800,977,20.63 EACH,2448,3264,22,177
photo-99.jpg,3,2090,2113,800,977,34.09 EACH,2448,3264,23,177
photo-99.jpg,3,2133,2156,800,960,7.19 EACH,2448,3264,23,160
photo-99.jpg,3,2176,2199,800,959,5.11 EACH,2448,3264,23,159
photo-99.jpg,3,2218,2243,801,960,3.13 EACH,2448,3264,25,159
photo-99.jpg,3,2261,2285,801,997,316.99 EACH,2448,3264,24,196
photo-99.jpg,3,2304,2328,801,962,9.63 EACH,2448,3264,24,161
photo-99.jpg,1,1006,1025,433,537,183.60,2448,3264,19,104
photo-99.jpg,3,1042,1069,388,519,64.65 \A,2448,3264,27,131
photo-99.jpg,3,1080,1118,357,502,6.66%/yf,2448,3264,38,145
photo-99.jpg,3,1117,1150,394,520,18.58*/,2448,3264,33,126
photo-99.jpg,3,1172,1194,389,503,8.32t^H,2448,3264,22,114
photo-99.jpg,1,1213,1233,435,521,24.00,2448,3264,20,86
photo-99.jpg,3,1242,1274,393,521,31.92 ^,2448,3264,32,128
photo-99.jpg,1,1295,1315,436,521,18.43,2448,3264,20,85
photo-99.jpg,1,1337,1356,436,522,37.50,2448,3264,19,86
photo-99.jpg,1,996,1015,1264,1296,60,2448,3264,19,32
photo-99.jpg,1,1040,1061,1022,1068,30.,2448,3264,21,46
photo-99.jpg,3,1040,1059,1143,1188,■15,2448,3264,19,45
photo-99.jpg,1,1037,1057,1265,1297,45,2448,3264,20,32
photo-99.jpg,1,1078,1098,1267,1280,1,2448,3264,20,13
photo-99.jpg,3,1063,1084,2017,2153,POfiA2240,2448,3264,21,136
photo-99.jpg,3,1105,1124,2085,2154,RACK,2448,3264,19,69
photo-99.jpg,3,1146,1166,2035,2139,ADR285,2448,3264,20,104
photo-99.jpg,1,1119,1139,1267,1281,1,2448,3264,20,14
photo-99.jpg,1,1163,1181,1146,1159,2,2448,3264,18,13
photo-99.jpg,3,1175,1179,1270,1280,—,2448,3264,4,10
photo-99.jpg,3,1190,1231,1125,1200,&,2448,3264,41,75
photo-99.jpg,3,1227,1248,2020,2157,SAPA6010,2448,3264,21,137
photo-99.jpg,3,1268,1289,2021,2158,SAPA6003,2448,3264,21,137
photo-99.jpg,3,1309,1330,2057,2159,SC5365,2448,3264,21,102
photo-99.jpg,3,1351,1371,2059,2159,SCAL23,2448,3264,20,100
photo-99.jpg,3,1391,1413,2058,2161,SC3039,2448,3264,22,103
photo-99.jpg,3,1433,1455,2025,2161,SCDO3056,2448,3264,22,136
photo-99.jpg,3,1475,1496,2060,2162,SC3030,2448,3264,21,102
photo-99.jpg,3,1516,1537,2061,2163,SP3321,2448,3264,21,102
photo-99.jpg,3,1557,1579,2060,2165,SPMESS,2448,3264,22,105
photo-99.jpg,3,1599,1620,2060,2165,SPTEAT,2448,3264,21,105
photo-99.jpg,3,1642,1662,2064,2166,SPW045,2448,3264,20,102
photo-99.jpg,3,1685,1705,2048,2168,STPA125,2448,3264,20,120
photo-99.jpg,3,1284,1305,1147,1164,'1,2448,3264,21,17
photo-99.jpg,1,1283,1303,1271,1285,1,2448,3264,20,14
photo-99.jpg,1,1328,1345,1148,1162,1,2448,3264,17,14
photo-99.jpg,1,1325,1344,1273,1285,1,2448,3264,19,12
photo-99.jpg,1,1379,1399,477,522,11.,2448,3264,20,45
photo-99.jpg,1,1367,1385,1274,1285,1,2448,3264,18,11
photo-99.jpg,3,1396,1471,1126,1188,s,2448,3264,75,62
photo-99.jpg,1,1421,1441,438,506,4.13,2448,3264,20,68
photo-99.jpg,1,1463,1483,437,506,7.16,2448,3264,20,69
photo-99.jpg,3,1496,1525,397,505,5.00\/,2448,3264,29,108
photo-99.jpg,3,1533,1567,398,507,2.52N/,2448,3264,34,109
photo-99.jpg,3,1580,1610,399,507,4.10*/,2448,3264,30,108
photo-99.jpg,3,1623,1654,399,525,10.95V/,2448,3264,31,126
photo-99.jpg,3,1671,1700,400,508,5.25 ©i,2448,3264,29,108
photo-99.jpg,3,1711,1739,399,543,127.80\/,2448,3264,28,144
photo-99.jpg,3,1755,1785,375,526,62.55l/L,2448,3264,30,151
photo-99.jpg,1,1803,1824,424,526,63.361,2448,3264,21,102
photo-99.jpg,3,1835,1866,384,526,52.32v/*,2448,3264,31,142
photo-99.jpg,1,1408,1427,1274,1287,1,2448,3264,19,13
photo-99.jpg,1,1449,1469,1274,1289,2,2448,3264,20,15
photo-99.jpg,1,1492,1511,1274,1288,1,2448,3264,19,14
photo-99.jpg,3,1527,1565,1140,1179,©,2448,3264,38,39
photo-99.jpg,1,1533,1552,1276,1290,2,2448,3264,19,14
photo-99.jpg,1,1575,1595,1277,1290,1,2448,3264,20,13
photo-99.jpg,1,1620,1641,1153,1167,3,2448,3264,21,14
photo-99.jpg,1,1617,1639,1277,1291,3,2448,3264,22,14
photo-99.jpg,1,1660,1680,1277,1290,3,2448,3264,20,13
photo-99.jpg,3,1661,1683,1150,1167,3’,2448,3264,22,17
photo-99.jpg,1,1703,1723,1279,1309,12,2448,3264,20,30
photo-99.jpg,1,1706,1724,1155,1185,12,2448,3264,18,30
photo-99.jpg,3,1726,1746,2119,2170,LI 3,2448,3264,20,51
photo-99.jpg,1,1745,1765,1279,1292,9,2448,3264,20,13
photo-99.jpg,3,1768,1788,2032,2171,STPA6100,2448,3264,20,139
photo-99.jpg,1,1787,1807,1280,1311,12,2448,3264,20,31
photo-99.jpg,1,1790,1809,1156,1170,2,2448,3264,19,14
photo-99.jpg,3,1810,1830,2123,2172,LI 6,2448,3264,20,49
photo-99.jpg,1,1830,1849,1281,1311,12,2448,3264,19,30
photo-99.jpg,3,1853,1873,2036,2174,ST?/-.9100,2448,3264,20,138
photo-99.jpg,1,1877,1897,1050,1064,5,2448,3264,20,14
photo-99.jpg,1,1872,1891,1281,1295,6,2448,3264,19,14
photo-99.jpg,1,1889,1908,459,508,5.4,2448,3264,19,49
photo-99.jpg,3,1925,1955,400,526,11.76V/,2448,3264,30,126
photo-99.jpg,3,1894,1917,2124,2177,<jI9,2448,3264,23,53
photo-99.jpg,1,1919,1939,1052,1065,3,2448,3264,20,13
photo-99.jpg,1,1914,1934,1283,1296,6,2448,3264,20,13
photo-99.jpg,3,1935,1997,2142,2215,m,2448,3264,62,73
photo-99.jpg,3,1936,1956,2039,2141,POPRl^,2448,3264,20,102
photo-99.jpg,3,1978,1999,2040,2142,FOPR60,2448,3264,21,102
photo-99.jpg,3,2020,2040,2078,2180,ST3869,2448,3264,20,102
photo-99.jpg,3,2063,2082,2040,2182,THDIPOPR,2448,3264,19,142
photo-99.jpg,3,2105,2124,2080,2183,TH5386,2448,3264,19,103
photo-99.jpg,3,2147,2167,2063,2185,TOXHD40,2448,3264,20,122
photo-99.jpg,3,2190,2209,2065,2187,TOXHD23,2448,3264,19,122
photo-99.jpg,3,1961,1982,1046,1066,Z,2448,3264,21,20
photo-99.jpg,1,1956,1975,1283,1297,2,2448,3264,19,14
photo-99.jpg,1,1958,1978,1158,1172,0,2448,3264,20,14
photo-99.jpg,3,1975,1995,439,486,.00,2448,3264,20,47
photo-99.jpg,1,2004,2023,1052,1065,1,2448,3264,19,13
photo-99.jpg,1,2000,2020,1159,1172,0,2448,3264,20,13
photo-99.jpg,1,1998,2017,1283,1296,1,2448,3264,19,13
photo-99.jpg,3,2018,2037,440,486,.00,2448,3264,19,46
photo-99.jpg,3,2031,2071,1137,1193,<D,2448,3264,40,56
photo-99.jpg,1,2040,2058,1285,1298,2,2448,3264,18,13
photo-99.jpg,3,2059,2090,400,527,41.26^,2448,3264,31,127
photo-99.jpg,3,2102,2127,400,526,34.09\X,2448,3264,25,126
photo-99.jpg,3,2071,2115,1143,1193,©,2448,3264,44,50
photo-99.jpg,1,2130,2150,1053,1067,3,2448,3264,20,14
photo-99.jpg,1,2124,2143,1285,1299,3,2448,3264,19,14
photo-99.jpg,1,2127,2146,1159,1174,0,2448,3264,19,15
photo-99.jpg,3,2146,2166,439,485,.00,2448,3264,20,46
photo-99.jpg,3,2174,2211,399,485,.ns/,2448,3264,37,86
photo-99.jpg,1,2167,2186,1285,1298,1,2448,3264,19,13
photo-99.jpg,1,2189,2208,493,507,5,2448,3264,19,14
photo-99.jpg,3,2220,2254,384,452,8v/ i,2448,3264,34,68
photo-99.jpg,1,2209,2228,1286,1300,6,2448,3264,19,14
photo-99.jpg,1,2212,2233,1162,1175,6,2448,3264,21,13
photo-99.jpg,1,2231,2252,457,525,18.7,2448,3264,21,68
photo-99.jpg,1,2274,2295,458,544,316.9,2448,3264,21,86
photo-99.jpg,3,2311,2344,397,507,9.63\/,2448,3264,33,110
photo-99.jpg,3,2232,2251,2084,2189,TRGA17,2448,3264,19,105
photo-99.jpg,3,2274,2294,2086,2191,WHFR50,2448,3264,20,105
photo-99.jpg,3,2258,2270,1287,1300,l,2448,3264,12,13
photo-99.jpg,1,2294,2313,1287,1301,1,2448,3264,19,14
photo-100.jpg,2,1045,1071,1441,1959,MAGNETIC TOOL/KNIFE RACK 60CM (24),2448,3264,26,518
photo-100.jpg,2,1088,1110,1434,1958,PASTRY DOCKER WIDTH OF ROLLER 115MM,2448,3264,22,524
photo-100.jpg,2,1123,1156,1360,1958,POTATO MASHER S/S 125X645 MM 18/10 '£‘J' ',2448,3264,33,598
photo-100.jpg,2,1172,1193,1415,1957,"POTATO RICER 40 CM STAINLESS 110X110,",2448,3264,21,542
photo-100.jpg,2,1213,1235,1359,1960,SAUCEPAN ALUMINIUM PREMIER 3.5LT 22X11CM,2448,3264,22,601
photo-100.jpg,2,1253,1280,1360,1959,"SCALES ELEC 5KG/1 ,'GM INC ^LITHIUM BATTERY",2448,3264,27,599
photo-100.jpg,2,1296,1318,1359,1957,SPOON! WOODEN MIXING 30CM (12) BEECHWOOD,2448,3264,22,598
photo-100.jpg,2,1338,1360,1359,1957,SPOON WOODEN MIXING 40CM (16) BEECHWOOD,2448,3264,22,598
photo-100.jpg,2,1380,1401,1359,1957,SPOON WOODEN MIXING 50CM (20) BEECHWOOD,2448,3264,21,598
photo-100.jpg,2,1422,1444,1480,1957,STRAINER CONICAL S/S 30CM COURSE,2448,3264,22,477
photo-100.jpg,2,1463,1487,1389,1957,TONG X/H/DDELUXE S/S 9 23CM NO CLIP,2448,3264,24,568
photo-100.jpg,1,1026,1046,413,500,30.00,2448,3264,20,87
photo-100.jpg,1,1068,1088,412,501,20.00,2448,3264,20,89
photo-100.jpg,1,1111,1131,413,501,40.00,2448,3264,20,88
photo-100.jpg,3,1032,1056,776,954,15.00 EACH,2448,3264,24,178
photo-100.jpg,3,1075,1097,777,955,20.00 EACH,2448,3264,22,178
photo-100.jpg,3,1117,1139,777,955,"40,00 EACH",2448,3264,22,178
photo-100.jpg,3,1159,1181,776,954,55.00 EACH,2448,3264,22,178
photo-100.jpg,3,1201,1223,776,954,18.43 EACH,2448,3264,22,178
photo-100.jpg,3,1244,1266,776,954,40.00 EACH,2448,3264,22,178
photo-100.jpg,3,1286,1307,776,936,1.52 EACH,2448,3264,21,160
photo-100.jpg,3,1329,1349,775,935,1.90 EACH,2448,3264,20,160
photo-100.jpg,3,1371,1392,775,936,2.97 EACH,2448,3264,21,161
photo-100.jpg,3,1413,1439,757,953,"35.00 EACH ,",2448,3264,26,196
photo-100.jpg,3,1456,1477,775,934,3.13 EACH,2448,3264,21,159
photo-100.jpg,1,1039,1059,1137,1151,2,2448,3264,20,14
photo-100.jpg,1,1043,1062,1261,1275,2,2448,3264,19,14
photo-100.jpg,3,1050,1069,2013,2151,MARA5170,2448,3264,19,138
photo-100.jpg,3,1092,1111,2081,2149,PADO,2448,3264,19,68
photo-100.jpg,3,1133,1152,2011,2149,POMASSLA,2448,3264,19,138
photo-100.jpg,3,1175,1194,2014,2149,PORI3342,2448,3264,19,135
photo-100.jpg,3,1217,1235,2013,2150,SAPA6003,2448,3264,18,137
photo-100.jpg,3,1258,1277,2063,2150,SCEL5,2448,3264,19,87
photo-100.jpg,3,1300,1319,2046,2149,SPWO30,2448,3264,19,103
photo-100.jpg,3,1342,1360,2046,2149,SPWO40,2448,3264,18,103
photo-100.jpg,3,1383,1402,2046,2149,SPWO50,2448,3264,19,103
photo-100.jpg,3,1424,1443,2047,2149,ST3872,2448,3264,19,102
photo-100.jpg,3,1466,1487,2030,2150,TOXHD23,2448,3264,21,120
photo-100.jpg,1,1083,1101,1137,1151,1,2448,3264,18,14
photo-100.jpg,1,1086,1103,1261,1274,1,2448,3264,17,13
photo-100.jpg,3,1122,1143,1133,1190,urn#,2448,3264,21,57
photo-100.jpg,3,1154,1173,413,459,.00,2448,3264,19,46
photo-100.jpg,1,1164,1182,1030,1044,1,2448,3264,18,14
photo-100.jpg,1,1165,1187,1261,1275,1,2448,3264,22,14
photo-100.jpg,3,1165,1189,1137,1151,Q,2448,3264,24,14
photo-100.jpg,1,1197,1216,414,500,55.29,2448,3264,19,86
photo-100.jpg,1,1239,1259,413,501,40.00,2448,3264,20,88
photo-100.jpg,1,1282,1301,414,482,1.52,2448,3264,19,68
photo-100.jpg,1,1325,1344,412,482,1.90,2448,3264,19,70
photo-100.jpg,1,1368,1387,413,481,5.94,2448,3264,19,68
photo-100.jpg,1,1410,1430,412,500,35.00,2448,3264,20,88
photo-100.jpg,1,1453,1472,413,499,12.52,2448,3264,19,86
photo-100.jpg,1,1208,1226,1138,1151,3,2448,3264,18,13
photo-100.jpg,1,1210,1229,1261,1275,3,2448,3264,19,14
photo-100.jpg,1,1249,1268,1137,1151,1,2448,3264,19,14
photo-100.jpg,3,1251,1270,1258,1274,i,2448,3264,19,16
photo-100.jpg,1,1291,1310,1136,1151,1,2448,3264,19,15
photo-100.jpg,1,1293,1312,1260,1274,1,2448,3264,19,14
photo-100.jpg,1,1334,1352,1136,1150,1,2448,3264,18,14
photo-100.jpg,1,1335,1354,1260,1274,1,2448,3264,19,14
photo-100.jpg,1,1377,1396,1261,1274,2,2448,3264,19,13
photo-100.jpg,1,1376,1394,1136,1150,2,2448,3264,18,14
photo-100.jpg,1,1417,1436,1136,1149,1,2448,3264,19,13
photo-100.jpg,1,1419,1437,1260,1274,1,2448,3264,18,14
photo-100.jpg,1,1460,1478,1136,1149,4,2448,3264,18,13
photo-100.jpg,1,1461,1479,1261,1274,4,2448,3264,18,13
photo-101.jpg,2,981,1002,1458,1942,BRUSH PASTRY 38MM NATURAL 1 1/2,2448,3264,21,484
photo-101.jpg,2,1022,1042,1440,1941,FRYPAN ALUMINIUM 25CM (10*) PREMIER,2448,3264,20,501
photo-101.jpg,2,1055,1081,1542,1942,GRATER MICROPLANE FINE' 35002,2448,3264,26,400
photo-101.jpg,2,1100,1122,1469,1942,LID STEAM PAN 1/6 W/HANDLE CAMBRO,2448,3264,22,473
photo-101.jpg,2,1140,1164,1603,2124,"PAWO3430 , .* 'PADDLE WOODEN 75CM (30)",2448,3264,24,521
photo-101.jpg,2,1180,1202,1366,1941,SAUCEPAN ALUMINIUM PREMIER 3.5LT 22X11CM,2448,3264,22,575
photo-101.jpg,2,1214,1241,1367,1940,SPOON WOODEN^MIXING*'3tfcA ^12) BEECHWOOD,2448,3264,27,573
photo-101.jpg,2,1260,1281,1467,1941,STEAM PAN 1/1 65MM DEEP 530X325MM,2448,3264,21,474
photo-101.jpg,2,1299,1322,1453,1941,STEAM PAN 2/6 ~100MM DEEP 175X161MM,2448,3264,23,488
photo-101.jpg,2,1338,1359,1367,1940,STOCKPOT ALUMINIUM PREMIER 32L 350X320MM,2448,3264,21,573
photo-101.jpg,2,1377,1403,1524,1940,TONG- X/H/D DELUXE S/S 9 £3CM,2448,3264,26,416
photo-101.jpg,3,969,991,818,968,1.57 EACH,2448,3264,22,150
photo-101.jpg,3,1009,1030,817,985,14.70 EACH,2448,3264,21,168
photo-101.jpg,3,1050,1070,817,984,25.00 EACH,2448,3264,20,167
photo-101.jpg,3,1089,1110,817,968,2.51 EACH,2448,3264,21,151
photo-101.jpg,3,1129,1150,816,984,15.96 EACH,2448,3264,21,168
photo-101.jpg,3,1169,1192,781,983,18.43 EACH ; ::,2448,3264,23,202
photo-101.jpg,3,1210,1230,815,966,1.52 EACH,2448,3264,20,151
photo-101.jpg,3,1250,1270,815,982,11.88 EACH,2448,3264,20,167
photo-101.jpg,3,1289,1309,809,965,5.28 EACH',2448,3264,20,156
photo-101.jpg,3,1329,1349,814,982,74.40 EACH,2448,3264,20,168
photo-101.jpg,3,1368,1389,814,964,3.13 EACH,2448,3264,21,150
photo-101.jpg,1,966,984,481,546,4.71,2448,3264,18,65
photo-101.jpg,1,1005,1024,480,562,44.10,2448,3264,19,82
photo-101.jpg,1,1045,1063,479,562,25.00,2448,3264,18,83
photo-101.jpg,1,1086,1103,479,560,10.04,2448,3264,17,81
photo-101.jpg,1,1125,1143,479,560,15.96,2448,3264,18,81
photo-101.jpg,1,1165,1184,478,559,55.29,2448,3264,19,81
photo-101.jpg,1,1205,1223,478,542,6.08,2448,3264,18,64
photo-101.jpg,3,1245,1266,478,563,"JL1,88",2448,3264,21,85
photo-101.jpg,1,1284,1303,478,559,21.12,2448,3264,19,81
photo-101.jpg,1,1324,1343,476,558,74.40,2448,3264,19,82
photo-101.jpg,1,1365,1382,476,558,12.52,2448,3264,17,82
photo-101.jpg,3,986,1003,2028,2127,BRPA38,2448,3264,17,99
photo-101.jpg,3,1024,1042,1994,2124,FRPA6125,2448,3264,18,130
photo-101.jpg,3,1064,1082,2006,2125,GRMIFI v,2448,3264,18,119
photo-101.jpg,3,1098,1125,1991,2126,LICA1/6H,2448,3264,27,135
photo-101.jpg,1,978,996,1275,1289,3,2448,3264,18,14
photo-101.jpg,1,977,995,1158,1171,3,2448,3264,18,13
photo-101.jpg,1,1017,1035,1274,1287,3,2448,3264,18,13
photo-101.jpg,1,1016,1034,1157,1169,3,2448,3264,18,12
photo-101.jpg,3,1056,1075,1241,1287,1 ’,2448,3264,19,46
photo-101.jpg,1,1055,1073,1156,1170,1,2448,3264,18,14
photo-101.jpg,1,1096,1114,1274,1287,4,2448,3264,18,13
photo-101.jpg,1,1095,1113,1157,1170,4,2448,3264,18,13
photo-101.jpg,1,1136,1154,1274,1286,1,2448,3264,18,12
photo-101.jpg,1,1134,1153,1156,1169,1,2448,3264,19,13
photo-101.jpg,3,1182,1202,1992,2125,SAPA6003,2448,3264,20,133
photo-101.jpg,3,1223,1241,2026,2124,SPW030,2448,3264,18,98
photo-101.jpg,3,1262,1280,2009,2124,STPA165,2448,3264,18,115
photo-101.jpg,3,1302,1320,1992,2124,STPA6100,2448,3264,18,132
photo-101.jpg,3,1341,1359,1993,2125,STPOPR32,2448,3264,18,132
photo-101.jpg,3,1380,1399,2009,2125,TOXHD23,2448,3264,19,116
photo-101.jpg,1,1174,1194,1273,1290,3,2448,3264,20,17
photo-101.jpg,1,1174,1193,1155,1169,3,2448,3264,19,14
photo-101.jpg,1,1215,1234,1273,1286,4,2448,3264,19,13
photo-101.jpg,1,1215,1233,1155,1169,4,2448,3264,18,14
photo-101.jpg,1,1256,1273,1273,1286,1,2448,3264,17,13
photo-101.jpg,1,1254,1273,1155,1168,1,2448,3264,19,13
photo-101.jpg,1,1295,1312,1273,1286,4,2448,3264,17,13
photo-101.jpg,1,1294,1312,1155,1168,4,2448,3264,18,13
photo-101.jpg,1,1335,1352,1273,1286,1,2448,3264,17,13
photo-101.jpg,1,1333,1352,1155,1168,1,2448,3264,19,13
photo-101.jpg,1,1374,1391,1272,1285,4,2448,3264,17,13
photo-101.jpg,1,1373,1391,1153,1167,4,2448,3264,18,14
photo-102.jpg,2,1040,1058,1775,1971,GLASS CRYSTA-3,2448,3264,18,196
photo-102.jpg,2,1076,1100,1521,2151,ROCOSL2CL3 ROBOT COUPE SLICER 2 MM FOR CL30,2448,3264,24,630
photo-102.jpg,2,1112,1136,1420,1971,ROBOT COUPE SLICER FOR R201/301/302 4MM,2448,3264,24,551
photo-102.jpg,2,1152,1176,1420,1971,THERMOMETER DIGITAL WATERPROOF -40-200C,2448,3264,24,551
photo-102.jpg,1,1011,1032,526,607,33.60,2448,3264,21,81
photo-102.jpg,3,1019,1043,863,1012,2.80 EACH,2448,3264,24,149
photo-102.jpg,3,1059,1082,862,1028,90.00 EACH,2448,3264,23,166
photo-102.jpg,3,1098,1121,861,1028,90.00 EACH,2448,3264,23,167
photo-102.jpg,3,1138,1161,861,1028,23.00 EACH,2448,3264,23,167
photo-102.jpg,1,1029,1050,1199,1227,12,2448,3264,21,28
photo-102.jpg,3,1041,1061,2021,2151,GL744017,2448,3264,20,130
photo-102.jpg,3,1119,1139,2006,2151,ROCOSL4X4,2448,3264,20,145
photo-102.jpg,3,1158,1178,2021,2152,THDIWAPR,2448,3264,20,131
photo-102.jpg,1,1033,1051,1314,1342,12,2448,3264,18,28
photo-102.jpg,3,1050,1070,526,569,.00,2448,3264,20,43
photo-102.jpg,1,1066,1084,1099,1111,1,2448,3264,18,12
photo-102.jpg,1,1068,1087,1198,1211,0,2448,3264,19,13
photo-102.jpg,1,1073,1091,1314,1326,1,2448,3264,18,12
photo-102.jpg,3,1090,1110,525,567,.00,2448,3264,20,42
photo-102.jpg,1,1105,1123,1098,1111,1,2448,3264,18,13
photo-102.jpg,1,1108,1126,1197,1210,0,2448,3264,18,13
photo-102.jpg,1,1112,1130,1313,1326,1,2448,3264,18,13
photo-102.jpg,1,1130,1151,525,606,23.00,2448,3264,21,81
photo-102.jpg,1,1147,1165,1197,1210,1,2448,3264,18,13
photo-102.jpg,1,1151,1169,1314,1326,1,2448,3264,18,12
photo-103.jpg,2,1008,1028,1537,1922,DOCKET HOLDER 75CM PLASTIC,2448,3264,20,385
photo-103.jpg,2,1048,1067,1666,1922,SPIKE METAL DOCKET,2448,3264,19,256
photo-103.jpg,2,1084,1109,1378,1924,TONG X/H/D DELUXE S/S 16 40CM NO CtlP,2448,3264,25,546
photo-103.jpg,3,1003,1025,789,961,13.92 EACH,2448,3264,22,172
photo-103.jpg,3,1045,1066,790,945,2.79 EACH,2448,3264,21,155
photo-103.jpg,3,1084,1106,790,945,5.11 EACH,2448,3264,22,155
photo-103.jpg,1,1002,1022,439,525,13.92,2448,3264,20,86
photo-103.jpg,1,1042,1063,440,508,2.79,2448,3264,21,68
photo-103.jpg,1,1083,1104,440,508,5.11,2448,3264,21,68
photo-103.jpg,3,1006,1026,2005,2104,D0H075,2448,3264,20,99
photo-103.jpg,3,1045,1065,2020,2104,SPIKE,2448,3264,20,84
photo-103.jpg,3,1085,1105,1990,2106,TOXHD40,2448,3264,20,116
photo-103.jpg,1,1007,1027,1254,1268,1,2448,3264,20,14
photo-103.jpg,1,1008,1026,1135,1149,1,2448,3264,18,14
photo-103.jpg,1,1047,1066,1136,1149,1,2448,3264,19,13
photo-103.jpg,1,1048,1067,1255,1268,1,2448,3264,19,13
photo-103.jpg,1,1086,1106,1136,1150,1,2448,3264,20,14
photo-103.jpg,1,1086,1106,1255,1270,1,2448,3264,20,15
photo-104.jpg,2,1128,1150,1854,2165,THICK CREAM 5L BTL,3264,2448,22,311
photo-104.jpg,2,1162,1185,1787,2165,CUV BAKERS FLOUR 12.5KG,3264,2448,23,378
photo-104.jpg,2,1196,1219,1772,2164,JALAPENOS SLICED A10 TIN,3264,2448,23,392
photo-104.jpg,2,1231,1255,1785,2163,SLICED PEPERONI - HANS 1,3264,2448,24,378
photo-104.jpg,2,1265,1290,1804,2164,AIOLI GARLIC SAUCE 1KG,3264,2448,25,360
photo-104.jpg,2,1304,1325,1913,2163,SALT 10 KG SAXA,3264,2448,21,250
photo-104.jpg,2,1335,1360,1763,2162,CW DISHWASH POWDER 5KG,3264,2448,25,399
photo-104.jpg,2,1369,1396,1742,2162,CRUSHED TOMATOES RIV 10K,3264,2448,27,420
photo-104.jpg,2,1406,1432,1840,2162,ANCHOVIES 720GM TIN,3264,2448,26,322
photo-104.jpg,2,1439,1467,1736,2162,WOMBAT CAESAR DRESSING 1,3264,2448,28,426
photo-104.jpg,2,1475,1502,1791,2162,MF DIJON MUSTARD 2.5KG,3264,2448,27,371
photo-104.jpg,2,1510,1538,1756,2162,ROLL TOWEL PREM BOX (1«X,3264,2448,28,406
photo-104.jpg,2,1545,1574,1756,2162,GLOVE XTR/LARGE PK100 PO,3264,2448,29,406
photo-104.jpg,2,1581,1610,1753,2161,MAINLAND MOZZ SHRED 2KG,3264,2448,29,408
photo-104.jpg,2,1617,1645,1769,2160,MLAND SWISS SLICE 1KG(10,3264,2448,28,391
photo-104.jpg,2,1654,1681,1796,2163,YEAST DRY ANGEST 500G,3264,2448,27,367
photo-104.jpg,1,1369,1387,1677,1694,4,3264,2448,18,17
photo-104.jpg,1,1438,1457,1680,1692,1,3264,2448,19,12
photo-104.jpg,1,1508,1528,1676,1716,0.5,3264,2448,20,40
photo-104.jpg,1,1580,1599,1675,1707,48,3264,2448,19,32
photo-104.jpg,1,1126,1144,1684,1696,1,3264,2448,18,12
photo-104.jpg,1,1110,1128,966,978,1,3264,2448,18,12
photo-104.jpg,1,1103,1123,676,761,17.000,3264,2448,20,85
photo-104.jpg,1,1101,1120,568,636,17.00,3264,2448,19,68
photo-104.jpg,3,1135,1157,566,760,12.750 153.00,3264,2448,22,194
photo-104.jpg,1,1171,1191,673,743,5.500,3264,2448,20,70
photo-104.jpg,1,1169,1187,565,618,6.50,3264,2448,18,53
photo-104.jpg,1,1206,1226,672,756,12.250,3264,2448,20,84
photo-104.jpg,1,1204,1223,564,632,98.00,3264,2448,19,68
photo-104.jpg,1,1241,1261,671,741,9.750,3264,2448,20,70
photo-104.jpg,1,1238,1258,562,616,9.75,3264,2448,20,54
photo-104.jpg,1,1276,1295,670,740,7.500,3264,2448,19,70
photo-104.jpg,1,1273,1292,561,616,7.50,3264,2448,19,55
photo-104.jpg,1,1310,1330,669,755,21.450,3264,2448,20,86
photo-104.jpg,1,1308,1328,559,630,21.45,3264,2448,20,71
photo-104.jpg,1,1346,1365,668,753,18.290,3264,2448,19,85
photo-104.jpg,1,1343,1362,558,629,73.16,3264,2448,19,71
photo-104.jpg,1,1381,1400,666,752,10.250,3264,2448,19,86
photo-104.jpg,1,1377,1397,556,627,10.25,3264,2448,20,71
photo-104.jpg,1,1415,1435,665,735,7.200,3264,2448,20,70
photo-104.jpg,1,1412,1432,555,610,7.20,3264,2448,20,55
photo-104.jpg,1,1450,1470,663,749,13.500,3264,2448,20,86
photo-104.jpg,1,1447,1467,553,624,13.50,3264,2448,20,71
photo-104.jpg,1,1485,1504,662,747,58.960,3264,2448,19,85
photo-104.jpg,1,1482,1502,553,623,29.48,3264,2448,20,70
photo-104.jpg,1,1520,1539,660,732,3.190,3264,2448,19,72
photo-104.jpg,1,1516,1536,550,621,19.14,3264,2448,20,71
photo-104.jpg,3,1552,1575,549,745,15.950 765.60,3264,2448,23,196
photo-104.jpg,1,1590,1610,657,744,17.600,3264,2448,20,87
photo-104.jpg,1,1586,1606,548,619,17.60,3264,2448,20,71
photo-104.jpg,1,1625,1645,656,727,2.500,3264,2448,20,71
photo-104.jpg,1,1623,1642,548,617,20.00,3264,2448,19,69
photo-104.jpg,1,1107,1127,805,876,0.000,3264,2448,20,71
photo-104.jpg,1,1141,1161,804,875,0.000,3264,2448,20,71
photo-104.jpg,1,1175,1194,802,873,0.000,3264,2448,19,71
photo-104.jpg,1,1209,1228,801,872,0.000,3264,2448,19,71
photo-104.jpg,1,1243,1263,800,871,0.000,3264,2448,20,71
photo-104.jpg,1,1278,1298,799,869,0.000,3264,2448,20,70
photo-104.jpg,1,1313,1332,797,869,1.950,3264,2448,19,72
photo-104.jpg,1,1348,1367,797,869,0.000,3264,2448,19,72
photo-104.jpg,1,1383,1403,795,867,0.000,3264,2448,20,72
photo-104.jpg,1,1417,1437,794,866,0.000,3264,2448,20,72
photo-104.jpg,1,1452,1472,792,865,0.000,3264,2448,20,73
photo-104.jpg,1,1488,1507,791,864,2.680,3264,2448,19,73
photo-104.jpg,1,1523,1542,790,862,1.740,3264,2448,19,72
photo-104.jpg,1,1557,1577,789,861,0.000,3264,2448,20,72
photo-104.jpg,1,1592,1612,787,860,0.000,3264,2448,20,73
photo-104.jpg,1,1628,1649,786,857,0.000,3264,2448,21,71
photo-104.jpg,1,1160,1179,1681,1711,12,3264,2448,19,30
photo-104.jpg,1,1144,1163,963,993,12,3264,2448,19,30
photo-104.jpg,1,1195,1213,1683,1695,1,3264,2448,18,12
photo-104.jpg,1,1229,1248,1680,1695,8,3264,2448,19,15
photo-104.jpg,1,1264,1283,1682,1694,1,3264,2448,19,12
photo-104.jpg,1,1299,1318,1681,1694,1,3264,2448,19,13
photo-104.jpg,1,1334,1353,1681,1693,1,3264,2448,19,12
photo-104.jpg,1,1351,1369,955,972,4,3264,2448,18,17
photo-104.jpg,1,1403,1422,1680,1692,1,3264,2448,19,12
photo-104.jpg,1,1473,1492,1679,1692,1,3264,2448,19,13
photo-104.jpg,1,1491,1510,951,992,0.5,3264,2448,19,41
photo-104.jpg,1,1545,1563,1675,1691,6,3264,2448,18,16
photo-104.jpg,1,1527,1544,950,966,6,3264,2448,17,16
photo-104.jpg,1,1561,1580,949,980,48,3264,2448,19,31
photo-104.jpg,1,1615,1634,1676,1690,1,3264,2448,19,14
photo-104.jpg,1,1596,1615,950,964,1,3264,2448,19,14
photo-104.jpg,1,1651,1670,1674,1689,8,3264,2448,19,15
photo-104.jpg,1,1632,1651,946,963,6,3264,2448,19,17
photo-105.jpg,2,1139,1165,1797,2120,THICK CREAM 5L BTL,3264,2448,26,323
photo-105.jpg,2,1177,1202,1789,2119,SLICED PEPERONI 1KG,3264,2448,25,330
photo-105.jpg,2,1213,1238,1698,2119,SHRED HAM JULIENNE CUT 2,3264,2448,25,421
photo-105.jpg,2,1249,1274,1699,2119,BAM FRESH BASIL PESTD2LT,3264,2448,25,420
photo-105.jpg,2,1287,1311,1686,2119,CRUSHED TOMATOES RIV 10K,3264,2448,24,433
photo-105.jpg,2,1324,1347,1706,2119,HEINZ TOMATO PASTE 3.15K,3264,2448,23,413
photo-105.jpg,2,1360,1383,1720,2121,P/APPLE PIZZA CUT SY 3KG,3264,2448,23,401
photo-105.jpg,2,1398,1420,1713,2122,GLOVES LG VINYL C-GV0008,3264,2448,22,409
photo-105.jpg,2,1435,1456,1693,2121,GLOVES MD VINYL C-GV0002,3264,2448,21,428
photo-105.jpg,2,1472,1493,1703,2122,GLOVE XTR/LARGE PK100 PO,3264,2448,21,419
photo-105.jpg,2,1508,1529,1701,2122,MAINLAND MOZZ SHRED 2KG,3264,2448,21,421
photo-105.jpg,2,1544,1569,1716,2123,MLAND SWISS SLICE 1KG(10,3264,2448,25,407
photo-105.jpg,2,1581,1602,1745,2125,YEAST DRY ANGEST 500G,3264,2448,21,380
photo-105.jpg,2,1618,1641,1741,2123,B/S YOGURT GREEK 10KG,3264,2448,23,382
photo-105.jpg,2,1656,1677,1725,2124,SALAMI HUNGARIAN 13 KG,3264,2448,21,399
photo-105.jpg,1,1142,1160,703,777,0.000,3264,2448,18,74
photo-105.jpg,1,1177,1197,701,777,0.000,3264,2448,20,76
photo-105.jpg,1,1213,1232,701,775,0.000,3264,2448,19,74
photo-105.jpg,1,1249,1269,701,775,0.000,3264,2448,20,74
photo-105.jpg,1,1286,1305,700,774,0.000,3264,2448,19,74
photo-105.jpg,1,1322,1341,699,773,0.000,3264,2448,19,74
photo-105.jpg,1,1358,1377,699,773,0.000,3264,2448,19,74
photo-105.jpg,1,1395,1414,698,772,0.580,3264,2448,19,74
photo-105.jpg,1,1432,1450,698,772,0.580,3264,2448,18,74
photo-105.jpg,1,1468,1487,697,771,1.180,3264,2448,19,74
photo-105.jpg,1,1505,1524,696,771,0.000,3264,2448,19,75
photo-105.jpg,1,1541,1560,696,770,0.000,3264,2448,19,74
photo-105.jpg,1,1578,1597,695,770,0.000,3264,2448,19,75
photo-105.jpg,1,1616,1636,695,769,0.000,3264,2448,20,74
photo-105.jpg,1,1653,1673,694,770,0.000,3264,2448,20,76
photo-105.jpg,1,1142,1161,868,886,4,3264,2448,19,18
photo-105.jpg,1,1140,1160,567,656,17.000,3264,2448,20,89
photo-105.jpg,1,1140,1158,451,524,68.00,3264,2448,18,73
photo-105.jpg,1,1176,1196,566,656,12250,3264,2448,20,90
photo-105.jpg,1,1176,1195,450,524,98.00,3264,2448,19,74
photo-105.jpg,3,1212,1232,448,655,12.000 216.00,3264,2448,20,207
photo-105.jpg,1,1248,1268,564,654,22.950,3264,2448,20,90
photo-105.jpg,1,1248,1267,448,522,45.90,3264,2448,19,74
photo-105.jpg,1,1285,1305,563,653,18290,3264,2448,20,90
photo-105.jpg,1,1285,1303,447,520,73.16,3264,2448,18,73
photo-105.jpg,1,1321,1341,563,637,9.950,3264,2448,20,74
photo-105.jpg,1,1321,1340,446,520,19.90,3264,2448,19,74
photo-105.jpg,1,1358,1377,562,636,6.200,3264,2448,19,74
photo-105.jpg,1,1357,1376,445,520,7440,3264,2448,19,75
photo-105.jpg,1,1394,1414,561,636,3.190,3264,2448,20,75
photo-105.jpg,1,1431,1451,561,635,3.190,3264,2448,20,74
photo-105.jpg,1,1431,1449,444,502,6.38,3264,2448,18,58
photo-105.jpg,1,1467,1487,560,635,3.190,3264,2448,20,75
photo-105.jpg,1,1467,1486,442,518,12.76,3264,2448,19,76
photo-105.jpg,3,1504,1524,442,650,15350 765.60,3264,2448,20,208
photo-105.jpg,1,1541,1561,558,649,17.600,3264,2448,20,91
photo-105.jpg,1,1540,1559,441,516,3530,3264,2448,19,75
photo-105.jpg,1,1578,1598,557,632,2.500,3264,2448,20,75
photo-105.jpg,1,1577,1596,440,514,50.00,3264,2448,19,74
photo-105.jpg,1,1615,1636,557,647,28.950,3264,2448,21,90
photo-105.jpg,1,1614,1635,439,514,28.95,3264,2448,21,75
photo-105.jpg,1,1652,1672,556,648,20.950,3264,2448,20,92
photo-105.jpg,1,1652,1672,438,514,8330,3264,2448,20,76
photo-105.jpg,1,1147,1165,1617,1635,4,3264,2448,18,18
photo-105.jpg,1,1179,1197,868,885,8,3264,2448,18,17
photo-105.jpg,1,1183,1202,1618,1634,8,3264,2448,19,16
photo-105.jpg,1,1215,1233,867,900,18,3264,2448,18,33
photo-105.jpg,1,1218,1237,1618,1650,18,3264,2448,19,32
photo-105.jpg,1,1251,1270,866,883,2,3264,2448,19,17
photo-105.jpg,1,1255,1273,1619,1635,2,3264,2448,18,16
photo-105.jpg,1,1287,1306,865,883,4,3264,2448,19,18
photo-105.jpg,1,1291,1309,1618,1636,4,3264,2448,18,18
photo-105.jpg,1,1326,1345,1619,1636,2,3264,2448,19,17
photo-105.jpg,1,1323,1342,865,882,2,3264,2448,19,17
photo-105.jpg,1,1359,1378,865,898,12,3264,2448,19,33
photo-105.jpg,1,1362,1381,1620,1652,12,3264,2448,19,32
photo-105.jpg,1,1398,1417,1620,1636,2,3264,2448,19,16
photo-105.jpg,1,1396,1415,864,882,2,3264,2448,19,18
photo-105.jpg,3,1394,1413,396,503,8.38 —,3264,2448,19,107
photo-105.jpg,1,1435,1454,1620,1637,2,3264,2448,19,17
photo-105.jpg,1,1433,1451,864,881,2,3264,2448,18,17
photo-105.jpg,1,1469,1488,863,881,4,3264,2448,19,18
photo-105.jpg,1,1471,1490,1619,1638,4,3264,2448,19,19
photo-105.jpg,1,1508,1527,1621,1653,48,3264,2448,19,32
photo-105.jpg,1,1506,1525,864,896,48,3264,2448,19,32
photo-105.jpg,1,1545,1564,1620,1638,2,3264,2448,19,18
photo-105.jpg,1,1542,1561,863,880,2,3264,2448,19,17
photo-105.jpg,1,1581,1600,1621,1653,20,3264,2448,19,32
photo-105.jpg,1,1580,1598,862,895,20,3264,2448,18,33
photo-105.jpg,1,1618,1638,1624,1638,1,3264,2448,20,14
photo-105.jpg,1,1616,1636,864,878,1,3264,2448,20,14
photo-105.jpg,1,1656,1676,1621,1639,4,3264,2448,20,18
photo-105.jpg,1,1654,1673,861,879,4,3264,2448,19,18
photo-105.jpg,1,1697,1715,1623,1710,1584.43,3264,2448,18,87
photo-106.jpg,2,1073,1097,1736,2095,CIV BAKERS FLOUR 12^KG,3264,2448,24,359
photo-106.jpg,2,1103,1130,1636,2095,AY AM COCONUT CREAM 400ML 24,3264,2448,27,459
photo-106.jpg,2,1140,1164,1732,2094,■SUTT1 HERB SAUCE 4LT(3),3264,2448,24,362
photo-106.jpg,2,1172,1197,1722,2095,JALAPENOS SLICED A10 TIN,3264,2448,25,373
photo-106.jpg,2,1204,1230,1736,2093,SLICED PEPERONI - HANS 1,3264,2448,26,357
photo-106.jpg,2,1238,1264,1697,2093,CRUSHED TOMATOES RIV 10K,3264,2448,26,396
photo-106.jpg,2,1271,1297,1691,2093,CHAMPIGNONS PIECE &STEM2,3264,2448,26,402
photo-106.jpg,2,1305,1331,1742,2093,PIECES RAW CASHEW 1KG,3264,2448,26,351
photo-106.jpg,2,1338,1365,1720,2093,GLOVES LG VINYL C-GV0006,3264,2448,27,373
photo-106.jpg,2,1371,1399,1700,2092,GLOVES MD VINYL C-GV0002,3264,2448,28,392
photo-106.jpg,2,1404,1432,1709,2093,GLOVE XTR/LARGE PK100 PO,3264,2448,28,384
photo-106.jpg,2,1439,1465,1707,2092,MAINLAND MOZZ SHRED 2KG,3264,2448,26,385
photo-106.jpg,3,1045,1067,562,750,12.750 178.50,3264,2448,22,188
photo-106.jpg,1,1082,1100,667,735,2.900,3264,2448,18,68
photo-106.jpg,1,1078,1098,560,628,89.60,3264,2448,20,68
photo-106.jpg,1,1115,1134,665,750,10.500,3264,2448,19,85
photo-106.jpg,1,1111,1131,558,629,31.50,3264,2448,20,71
photo-106.jpg,1,1149,1167,665,734,8.950,3264,2448,18,69
photo-106.jpg,1,1145,1165,559,613,8.95,3264,2448,20,54
photo-106.jpg,1,1181,1200,664,746,11210,3264,2448,19,82
photo-106.jpg,1,1177,1197,557,626,85.75,3264,2448,20,69
photo-106.jpg,1,1215,1233,663,746,18.290,3264,2448,18,83
photo-106.jpg,1,1211,1230,556,625,36.58,3264,2448,19,69
photo-106.jpg,1,1248,1267,662,745,10.950,3264,2448,19,83
photo-106.jpg,1,1245,1264,555,624,32.85,3264,2448,19,69
photo-106.jpg,1,1282,1300,661,743,12.600,3264,2448,18,82
photo-106.jpg,1,1278,1297,554,622,12.60,3264,2448,19,68
photo-106.jpg,1,1315,1334,659,729,3.190,3264,2448,19,70
photo-106.jpg,1,1312,1330,552,607,6.38,3264,2448,18,55
photo-106.jpg,1,1349,1368,658,728,3.190,3264,2448,19,70
photo-106.jpg,1,1345,1364,551,606,3.19,3264,2448,19,55
photo-106.jpg,1,1381,1400,657,726,3.190,3264,2448,19,69
photo-106.jpg,1,1378,1398,549,618,19.14,3264,2448,20,69
photo-106.jpg,3,1412,1434,549,738,15.950 765.60,3264,2448,22,189
photo-106.jpg,1,1070,1089,1635,1666,14,3264,2448,19,31
photo-106.jpg,1,1171,1188,1639,1651,1,3264,2448,17,12
photo-106.jpg,1,1237,1254,1634,1650,2,3264,2448,17,16
photo-106.jpg,1,1270,1287,1634,1651,3,3264,2448,17,17
photo-106.jpg,1,1337,1355,1633,1650,2,3264,2448,18,17
photo-106.jpg,1,1371,1389,1636,1649,1,3264,2448,18,13
photo-106.jpg,1,1403,1422,1633,1649,6,3264,2448,19,16
photo-106.jpg,1,1438,1456,1633,1664,48,3264,2448,18,31
photo-106.jpg,1,1056,1074,945,975,14,3264,2448,18,30
photo-106.jpg,1,1051,1070,793,861,0.000,3264,2448,19,68
photo-106.jpg,1,1084,1103,792,860,0.000,3264,2448,19,68
photo-106.jpg,1,1117,1136,790,861,0.000,3264,2448,19,71
photo-106.jpg,1,1151,1170,791,859,0.000,3264,2448,19,68
photo-106.jpg,1,1183,1202,789,858,0.000,3264,2448,19,69
photo-106.jpg,1,1216,1236,787,857,0.000,3264,2448,20,70
photo-106.jpg,1,1250,1270,787,856,0.000,3264,2448,20,69
photo-106.jpg,1,1283,1303,786,854,0.000,3264,2448,20,68
photo-106.jpg,1,1317,1337,785,854,0.580,3264,2448,20,69
photo-106.jpg,1,1351,1370,783,853,0.290,3264,2448,19,70
photo-106.jpg,1,1383,1404,783,852,1.740,3264,2448,21,69
photo-106.jpg,1,1418,1437,782,850,0.000,3264,2448,19,68
photo-106.jpg,1,1090,1107,944,974,24,3264,2448,17,30
photo-106.jpg,1,1137,1154,1635,1652,3,3264,2448,17,17
photo-106.jpg,1,1123,1140,943,961,3,3264,2448,17,18
photo-106.jpg,1,1156,1174,946,959,1,3264,2448,18,13
photo-106.jpg,1,1203,1221,1635,1651,7,3264,2448,18,16
photo-106.jpg,1,1187,1206,941,958,7,3264,2448,19,17
photo-106.jpg,1,1221,1239,940,957,2,3264,2448,18,17
photo-106.jpg,1,1254,1273,939,956,3,3264,2448,19,17
photo-106.jpg,1,1304,1321,1636,1650,1,3264,2448,17,14
photo-106.jpg,1,1289,1306,942,954,1,3264,2448,17,12
photo-106.jpg,1,1322,1340,938,954,2,3264,2448,18,16
photo-106.jpg,1,1356,1374,940,953,1,3264,2448,18,13
photo-106.jpg,1,1388,1407,937,952,6,3264,2448,19,15
photo-106.jpg,1,1422,1440,936,966,48,3264,2448,18,30
photo-107.jpg,2,1115,1143,1727,2107,CW BAKERS FLOUR 12.5KG,3264,2448,28,380
photo-107.jpg,2,1152,1178,1720,2108,MUTTI HERB SAUCE 4LT(3),3264,2448,26,388
photo-107.jpg,2,1188,1215,1725,2108,SLICED PEPERONI - HANS 1,3264,2448,27,383
photo-107.jpg,2,1225,1251,1717,2107,CW LAUNDRY LIQUID 5LT •,3264,2448,26,390
photo-107.jpg,2,1261,1287,1782,2108,ANCHOVIES 720GM TIN,3264,2448,26,326
photo-107.jpg,2,1295,1324,1731,2105,PIECES RAW CASHEW 1KG,3264,2448,29,374
photo-107.jpg,2,1331,1360,1698,2105,MOROCCAN SEASONING 1KG,3264,2448,29,407
photo-107.jpg,2,1367,1397,1706,2104,GLOVES LG VINYL C-GV0006,3264,2448,30,398
photo-107.jpg,2,1404,1433,1685,2104,GLOVES MD VINYL C-GV0002,3264,2448,29,419
photo-107.jpg,2,1440,1469,1695,2104,GLOVE XTR/LARGE PK100 PO,3264,2448,29,409
photo-107.jpg,2,1477,1505,1716,2103,HD WIPES BL ROLL 65 C-WI*,3264,2448,28,387
photo-107.jpg,2,1513,1542,1692,2103,MAINLAND MOZZ SHRED 2KG,3264,2448,29,411
photo-107.jpg,3,1076,1102,448,655,12.750 102.00,3264,2448,26,207
photo-107.jpg,1,1118,1139,563,655,10.500,3264,2448,21,92
photo-107.jpg,1,1154,1176,563,654,12.250,3264,2448,22,91
photo-107.jpg,1,1191,1212,561,653,10.750,3264,2448,21,92
photo-107.jpg,1,1227,1248,560,650,10.250,3264,2448,21,90
photo-107.jpg,1,1264,1285,559,649,12.600,3264,2448,21,90
photo-107.jpg,1,1302,1321,558,649,12.500,3264,2448,19,91
photo-107.jpg,1,1338,1358,557,632,3.190,3264,2448,20,75
photo-107.jpg,1,1375,1395,557,631,3.190,3264,2448,20,74
photo-107.jpg,1,1411,1431,555,630,3.190,3264,2448,20,75
photo-107.jpg,1,1448,1469,554,646,11.990,3264,2448,21,92
photo-107.jpg,3,1481,1505,436,644,15.950 661.30,3264,2448,24,208
photo-107.jpg,1,1085,1106,703,777,0.000,3264,2448,21,74
photo-107.jpg,1,1122,1142,701,776,0.000,3264,2448,20,75
photo-107.jpg,1,1158,1178,700,774,0.000,3264,2448,20,74
photo-107.jpg,1,1195,1215,698,774,1.250,3264,2448,20,76
photo-107.jpg,1,1231,1252,698,772,0.000,3264,2448,21,74
photo-107.jpg,1,1268,1288,696,771,0.000,3264,2448,20,75
photo-107.jpg,1,1305,1325,695,771,0.000,3264,2448,20,76
photo-107.jpg,1,1342,1361,694,769,0.560,3264,2448,19,75
photo-107.jpg,1,1379,1399,694,768,0.560,3264,2448,20,74
photo-107.jpg,1,1415,1435,692,766,1.450,3264,2448,20,74
photo-107.jpg,1,1451,1472,691,767,1.090,3264,2448,21,76
photo-107.jpg,1,1489,1509,691,766,0.000,3264,2448,20,75
photo-107.jpg,1,1090,1108,870,885,6,3264,2448,18,15
photo-107.jpg,1,1113,1132,1618,1633,8,3264,2448,19,15
photo-107.jpg,1,1113,1134,446,522,31.50,3264,2448,21,76
photo-107.jpg,1,1151,1171,445,522,73.50,3264,2448,20,77
photo-107.jpg,3,1186,1208,365,520,13.75 --,3264,2448,22,155
photo-107.jpg,1,1224,1244,444,518,20.50,3264,2448,20,74
photo-107.jpg,1,1260,1281,442,517,25.20,3264,2448,21,75
photo-107.jpg,1,1298,1318,441,516,12.50,3264,2448,20,75
photo-107.jpg,3,1333,1354,419,498,6.36 «,3264,2448,21,79
photo-107.jpg,3,1370,1392,419,497,6.36 s,3264,2448,22,78
photo-107.jpg,3,1407,1428,411,512,15.95 •,3264,2448,21,101
photo-107.jpg,3,1441,1466,412,513,11.99 •,3264,2448,25,101
photo-107.jpg,1,1127,1147,868,885,3,3264,2448,20,17
photo-107.jpg,1,1149,1168,1617,1634,3,3264,2448,19,17
photo-107.jpg,1,1163,1182,868,883,6,3264,2448,19,15
photo-107.jpg,1,1184,1205,1617,1632,6,3264,2448,21,15
photo-107.jpg,1,1200,1218,868,882,1,3264,2448,18,14
photo-107.jpg,1,1221,1240,1619,1632,1,3264,2448,19,13
photo-107.jpg,1,1236,1254,865,881,2,3264,2448,18,16
photo-107.jpg,1,1256,1276,1615,1632,2,3264,2448,20,17
photo-107.jpg,1,1272,1291,863,879,2,3264,2448,19,16
photo-107.jpg,1,1292,1312,1615,1631,2,3264,2448,20,16
photo-107.jpg,1,1309,1327,865,878,1,3264,2448,18,13
photo-107.jpg,1,1329,1348,1617,1629,1,3264,2448,19,12
photo-107.jpg,1,1345,1364,861,878,2,3264,2448,19,17
photo-107.jpg,1,1365,1385,1613,1629,2,3264,2448,20,16
photo-107.jpg,1,1382,1401,861,877,2,3264,2448,19,16
photo-107.jpg,1,1402,1421,1612,1630,2,3264,2448,19,18
photo-107.jpg,1,1419,1437,860,875,5,3264,2448,18,15
photo-107.jpg,1,1438,1457,1613,1628,5,3264,2448,19,15
photo-107.jpg,1,1455,1475,862,876,1,3264,2448,20,14
photo-107.jpg,1,1474,1494,1616,1629,1,3264,2448,20,13
photo-107.jpg,1,1492,1511,858,890,54,3264,2448,19,32
photo-107.jpg,1,1511,1530,1612,1644,54,3264,2448,19,32
photo-108.jpg,2,1061,1086,1790,2157,CW BAKERS FLOUR 12.5KG,3264,2448,25,367
photo-108.jpg,2,1096,1120,1775,2158,JALAPENOS SLICED A10 TIN,3264,2448,24,383
photo-108.jpg,2,1131,1156,1789,2158,SLICED PEPERONI - HANS 1,3264,2448,25,369
photo-108.jpg,2,1167,1192,1844,2157,ANCHOVIES 720GM TIN,3264,2448,25,313
photo-108.jpg,2,1200,1226,1794,2156,PIECES RAW CASHEW 1KG,3264,2448,26,362
photo-108.jpg,2,1235,1261,1773,2155,GLOVES LG VINYL C-GV0006,3264,2448,26,382
photo-108.jpg,2,1268,1296,1752,2155,GLOVES MD VINYL C-GV0002,3264,2448,28,403
photo-108.jpg,2,1304,1332,1760,2155,GLOVE XTR/LARGE PK100 PO,3264,2448,28,395
photo-108.jpg,2,1339,1367,1757,2153,MAINLAND MOZZ SHRED 2KG,3264,2448,28,396
photo-108.jpg,2,1375,1402,1779,2153,SALAMI HUNGARIAN 1.5 KG,3264,2448,27,374
photo-108.jpg,1,1035,1054,806,878,0.000,3264,2448,19,72
photo-108.jpg,1,1031,1052,675,762,12.750,3264,2448,21,87
photo-108.jpg,1,1070,1090,806,876,0.000,3264,2448,20,70
photo-108.jpg,1,1105,1125,805,876,0.000,3264,2448,20,71
photo-108.jpg,1,1102,1121,674,760,12.250,3264,2448,19,86
photo-108.jpg,1,1140,1160,804,876,0.000,3264,2448,20,72
photo-108.jpg,1,1137,1157,673,760,10.250,3264,2448,20,87
photo-108.jpg,3,1171,1194,673,874,0.000 . 12.600,3264,2448,23,201
photo-108.jpg,1,1210,1229,802,873,0.290,3264,2448,19,71
photo-108.jpg,1,1246,1264,801,873,0.290,3264,2448,18,72
photo-108.jpg,1,1280,1299,800,870,1.450,3264,2448,19,70
photo-108.jpg,1,1315,1335,799,870,0.000,3264,2448,20,71
photo-108.jpg,1,1350,1371,798,870,0.000,3264,2448,21,72
photo-108.jpg,1,1347,1367,667,754,20.950,3264,2448,20,87
photo-108.jpg,1,1027,1047,564,635,76.50,3264,2448,20,71
photo-108.jpg,1,1067,1085,675,745,8.950,3264,2448,18,70
photo-108.jpg,1,1062,1082,563,619,8.95,3264,2448,20,56
photo-108.jpg,1,1097,1117,561,633,73.50,3264,2448,20,72
photo-108.jpg,1,1133,1153,561,633,20.50,3264,2448,20,72
photo-108.jpg,1,1167,1187,561,632,25.20,3264,2448,20,71
photo-108.jpg,1,1206,1225,671,742,3.190,3264,2448,19,71
photo-108.jpg,1,1202,1222,560,616,3.19,3264,2448,20,56
photo-108.jpg,1,1241,1261,670,742,3.190,3264,2448,20,72
photo-108.jpg,3,1236,1257,546,615,3.19',3264,2448,21,69
photo-108.jpg,1,1276,1296,670,741,3.190,3264,2448,20,71
photo-108.jpg,1,1273,1292,558,628,15.95,3264,2448,19,70
photo-108.jpg,3,1308,1332,556,753,15.950 861.30,3264,2448,24,197
photo-108.jpg,1,1344,1364,555,628,41.90,3264,2448,20,73
photo-108.jpg,1,1040,1058,966,981,6,3264,2448,18,15
photo-108.jpg,1,1059,1076,1685,1699,6,3264,2448,17,14
photo-108.jpg,1,1076,1093,969,980,1,3264,2448,17,11
photo-108.jpg,1,1094,1111,1687,1699,1,3264,2448,17,12
photo-108.jpg,1,1111,1128,966,980,6,3264,2448,17,14
photo-108.jpg,1,1128,1145,1685,1699,6,3264,2448,17,14
photo-108.jpg,1,1145,1163,964,980,2,3264,2448,18,16
photo-108.jpg,1,1163,1181,1683,1699,2,3264,2448,18,16
photo-108.jpg,1,1179,1197,963,979,2,3264,2448,18,16
photo-108.jpg,1,1197,1215,1682,1698,2,3264,2448,18,16
photo-108.jpg,1,1214,1232,965,977,1,3264,2448,18,12
photo-108.jpg,1,1232,1249,1686,1697,1,3264,2448,17,11
photo-108.jpg,1,1250,1267,964,976,1,3264,2448,17,12
photo-108.jpg,1,1267,1284,1685,1696,1,3264,2448,17,11
photo-108.jpg,1,1284,1302,961,974,5,3264,2448,18,13
photo-108.jpg,1,1302,1319,1681,1696,5,3264,2448,17,15
photo-108.jpg,1,1318,1338,959,989,54,3264,2448,20,30
photo-108.jpg,1,1337,1356,1681,1710,54,3264,2448,19,29
photo-108.jpg,1,1354,1373,958,974,2,3264,2448,19,16
photo-108.jpg,1,1372,1390,1680,1695,2,3264,2448,18,15
photo-109.jpg,2,1112,1135,1698,2068,CW BAKERS FLOUR 12.5KG,3264,2448,23,370
photo-109.jpg,2,1146,1171,1592,2069,AYAM COCONUT CREAM 400ML 24,3264,2448,25,477
photo-109.jpg,2,1184,1207,1693,2068,MUTTI HERB SAUCE 4LT(3),3264,2448,23,375
photo-109.jpg,2,1218,1243,1683,2070,JALAPENOS SLICED A10 TIN,3264,2448,25,387
photo-109.jpg,2,1253,1277,1697,2067,SLICED PEPERONI - HANS 1,3264,2448,24,370
photo-109.jpg,2,1287,1312,1655,2068,CRUSHED TOMATOES RIV 10K,3264,2448,25,413
photo-109.jpg,2,1324,1347,1650,2067,CHAMPIGNONS PIECE &STEM2,3264,2448,23,417
photo-109.jpg,2,1360,1383,1703,2066,PIECES RAW CASHEW 1KG,3264,2448,23,363
photo-109.jpg,2,1395,1419,1681,2067,GLOVES LG VINYL C-GV0006,3264,2448,24,386
photo-109.jpg,2,1431,1454,1661,2067,GLOVES MD VINYL C-GV0002,3264,2448,23,406
photo-109.jpg,2,1466,1489,1671,2067,GLOVE XTR/LARGE PK100 PO,3264,2448,23,396
photo-109.jpg,2,1502,1525,1668,2066,MAINLAND MOZZ SHRED 2KG,3264,2448,23,398
photo-109.jpg,1,1092,1112,695,769,0.000,3264,2448,20,74
photo-109.jpg,1,1129,1148,695,768,0.000,3264,2448,19,73
photo-109.jpg,1,1165,1185,695,768,0.000,3264,2448,20,73
photo-109.jpg,1,1201,1221,694,767,0.000,3264,2448,20,73
photo-109.jpg,1,1236,1256,693,766,0.000,3264,2448,20,73
photo-109.jpg,1,1272,1292,693,766,0.000,3264,2448,20,73
photo-109.jpg,1,1309,1328,692,766,0.000,3264,2448,19,74
photo-109.jpg,1,1344,1364,692,765,0.000,3264,2448,20,73
photo-109.jpg,1,1381,1401,692,764,0.580,3264,2448,20,72
photo-109.jpg,1,1417,1436,691,764,0.290,3264,2448,19,73
photo-109.jpg,1,1452,1472,691,764,1.740,3264,2448,20,73
photo-109.jpg,1,1489,1508,691,764,0.000,3264,2448,19,73
photo-109.jpg,3,1087,1110,445,650,12.750 178.50,3264,2448,23,205
photo-109.jpg,1,1127,1146,560,633,2.900,3264,2448,19,73
photo-109.jpg,1,1124,1144,445,517,69.60,3264,2448,20,72
photo-109.jpg,1,1163,1182,560,648,10.500,3264,2448,19,88
photo-109.jpg,1,1159,1180,444,518,31.50,3264,2448,21,74
photo-109.jpg,1,1199,1218,559,632,8.950,3264,2448,19,73
photo-109.jpg,1,1196,1216,444,501,8.95,3264,2448,20,57
photo-109.jpg,1,1234,1254,558,646,12.250,3264,2448,20,88
photo-109.jpg,1,1231,1252,443,516,85.75,3264,2448,21,73
photo-109.jpg,1,1270,1290,558,646,18.290,3264,2448,20,88
photo-109.jpg,1,1267,1287,443,516,36.58,3264,2448,20,73
photo-109.jpg,1,1307,1325,557,646,10.950,3264,2448,18,89
photo-109.jpg,1,1304,1324,442,516,32.85,3264,2448,20,74
photo-109.jpg,1,1343,1362,557,645,12.600,3264,2448,19,88
photo-109.jpg,1,1340,1361,441,514,12.60,3264,2448,21,73
photo-109.jpg,1,1379,1398,556,630,3.190,3264,2448,19,74
photo-109.jpg,3,1375,1397,366,497,6.38 ---,3264,2448,22,131
photo-109.jpg,1,1415,1435,556,630,3.190,3264,2448,20,74
photo-109.jpg,1,1413,1433,440,499,3.19,3264,2448,20,59
photo-109.jpg,1,1450,1470,556,629,3.190,3264,2448,20,73
photo-109.jpg,3,1447,1469,379,513,19.14-,3264,2448,22,134
photo-109.jpg,3,1485,1505,440,644,15.950 765.60,3264,2448,20,204
photo-109.jpg,1,1096,1115,859,891,14,3264,2448,19,32
photo-109.jpg,1,1112,1130,1592,1622,14,3264,2448,18,30
photo-109.jpg,1,1218,1237,1595,1607,1,3264,2448,19,12
photo-109.jpg,1,1288,1305,1592,1607,2,3264,2448,17,15
photo-109.jpg,1,1324,1341,1591,1606,3,3264,2448,17,15
photo-109.jpg,1,1395,1413,1590,1606,2,3264,2448,18,16
photo-109.jpg,1,1430,1448,1594,1605,1,3264,2448,18,11
photo-109.jpg,1,1465,1483,1591,1606,6,3264,2448,18,15
photo-109.jpg,1,1502,1518,1591,1622,48,3264,2448,16,31
photo-109.jpg,1,1132,1151,859,890,24,3264,2448,19,31
photo-109.jpg,1,1169,1186,859,875,3,3264,2448,17,16
photo-109.jpg,1,1182,1201,1592,1607,3,3264,2448,19,15
photo-109.jpg,1,1204,1223,862,873,1,3264,2448,19,11
photo-109.jpg,1,1239,1258,858,873,7,3264,2448,19,15
photo-109.jpg,1,1252,1271,1591,1607,7,3264,2448,19,16
photo-109.jpg,1,1275,1293,857,873,2,3264,2448,18,16
photo-109.jpg,1,1311,1329,856,873,3,3264,2448,18,17
photo-109.jpg,1,1347,1365,860,871,1,3264,2448,18,11
photo-109.jpg,1,1359,1377,1594,1605,1,3264,2448,18,11
photo-109.jpg,1,1382,1402,856,871,2,3264,2448,20,15
photo-109.jpg,1,1419,1437,859,870,1,3264,2448,18,11
photo-109.jpg,1,1454,1472,855,871,6,3264,2448,18,16
photo-109.jpg,1,1491,1509,855,887,48,3264,2448,18,32
photo-110.jpg,2,1148,1169,1892,2199,THICK CREAM 5L BTL,3264,2448,21,307
photo-110.jpg,2,1181,1204,1812,2200,JALAPENOS SLICED A10 TIN,3264,2448,23,388
photo-110.jpg,2,1217,1239,1825,2199,SLICED PEPERONI - HANS 1,3264,2448,22,374
photo-110.jpg,2,1251,1275,1797,2197,BAM FRESH BASIL PEST02LT,3264,2448,24,400
photo-110.jpg,2,1287,1310,1818,2197,CW LAUNDRY LIQUID 5LT •,3264,2448,23,379
photo-110.jpg,2,1321,1345,1784,2198,CRUSHED TOMATOES RIV 10K,3264,2448,24,414
photo-110.jpg,2,1360,1380,1881,2199,ANCHOVIES 720GM TIN,3264,2448,20,318
photo-110.jpg,2,1393,1416,1817,2198,P/APPLE PIZZA CUT SY 3KG,3264,2448,23,381
photo-110.jpg,2,1428,1451,1809,2198,GLOVES LG VINYL C-GV0008,3264,2448,23,389
photo-110.jpg,2,1462,1486,1790,2198,GLOVES MD VINYL C-GV0002,3264,2448,24,408
photo-110.jpg,2,1498,1522,1798,2197,GLOVE XTR/LARGE PK100 PO,3264,2448,24,399
photo-110.jpg,2,1533,1557,1796,2198,MAINLAND MOZZ SHRED 2KG,3264,2448,24,402
photo-110.jpg,2,1568,1593,1811,2198,MLAND SWISS SLICE 1KG(10,3264,2448,25,387
photo-110.jpg,1,1171,1189,1000,1013,1,3264,2448,18,13
photo-110.jpg,1,1129,1148,591,664,51.00,3264,2448,19,73
photo-110.jpg,1,1165,1183,592,648,6.50,3264,2448,18,56
photo-110.jpg,1,1200,1219,592,664,61.25,3264,2448,19,72
photo-110.jpg,1,1235,1255,591,662,22.95,3264,2448,20,71
photo-110.jpg,3,1257,1290,539,662,13.75/,3264,2448,33,123
photo-110.jpg,1,1306,1326,590,662,73.16,3264,2448,20,72
photo-110.jpg,1,1342,1362,590,662,10.25,3264,2448,20,72
photo-110.jpg,1,1377,1397,589,661,93.00,3264,2448,20,72
photo-110.jpg,3,1409,1433,553,644,6.38 S,3264,2448,24,91
photo-110.jpg,3,1438,1468,554,644,6.38 ^,3264,2448,30,90
photo-110.jpg,3,1476,1504,552,644,6.38 y,3264,2448,28,92
photo-110.jpg,1,1130,1150,704,792,17.000,3264,2448,20,88
photo-110.jpg,1,1166,1185,705,776,6.500,3264,2448,19,71
photo-110.jpg,1,1201,1221,704,791,12.250,3264,2448,20,87
photo-110.jpg,1,1237,1256,703,790,22.950,3264,2448,19,87
photo-110.jpg,1,1272,1292,703,790,13.750,3264,2448,20,87
photo-110.jpg,1,1308,1327,703,789,18.290,3264,2448,19,86
photo-110.jpg,1,1344,1362,703,789,10.250,3264,2448,18,86
photo-110.jpg,1,1379,1398,702,772,6.200,3264,2448,19,70
photo-110.jpg,1,1414,1434,702,773,3.190,3264,2448,20,71
photo-110.jpg,1,1449,1469,701,773,3.190,3264,2448,20,72
photo-110.jpg,1,1484,1504,700,773,3.190,3264,2448,20,73
photo-110.jpg,3,1520,1539,588,786,15.950 366.85,3264,2448,19,198
photo-110.jpg,1,1132,1152,835,908,0.000,3264,2448,20,73
photo-110.jpg,1,1168,1187,837,908,0.000,3264,2448,19,71
photo-110.jpg,1,1203,1222,837,907,0.000,3264,2448,19,70
photo-110.jpg,1,1239,1258,835,906,0.000,3264,2448,19,71
photo-110.jpg,1,1274,1294,835,906,1.250,3264,2448,20,71
photo-110.jpg,1,1309,1328,835,906,0.000,3264,2448,19,71
photo-110.jpg,1,1345,1363,834,906,0.000,3264,2448,18,72
photo-110.jpg,1,1381,1399,833,904,0.000,3264,2448,18,71
photo-110.jpg,1,1415,1435,833,904,0.580,3264,2448,20,71
photo-110.jpg,1,1451,1470,833,904,0.580,3264,2448,19,71
photo-110.jpg,1,1486,1506,832,904,0.580,3264,2448,20,72
photo-110.jpg,1,1522,1541,831,903,0.000,3264,2448,19,72
photo-110.jpg,1,1557,1576,831,903,0.000,3264,2448,19,72
photo-110.jpg,1,1251,1269,1723,1735,1,3264,2448,18,12
photo-110.jpg,1,1321,1339,1719,1736,4,3264,2448,18,17
photo-110.jpg,1,1392,1410,1720,1750,15,3264,2448,18,30
photo-110.jpg,1,1462,1480,1720,1735,2,3264,2448,18,15
photo-110.jpg,1,1498,1516,1719,1735,2,3264,2448,18,16
photo-110.jpg,1,1534,1552,1719,1749,23,3264,2448,18,30
photo-110.jpg,1,1145,1163,1722,1737,3,3264,2448,18,15
photo-110.jpg,1,1180,1198,1724,1736,1,3264,2448,18,12
photo-110.jpg,1,1206,1223,996,1012,5,3264,2448,17,16
photo-110.jpg,1,1216,1234,1721,1736,5,3264,2448,18,15
photo-110.jpg,1,1241,1259,998,1011,1,3264,2448,18,13
photo-110.jpg,1,1276,1294,998,1010,1,3264,2448,18,12
photo-110.jpg,1,1286,1305,1723,1736,1,3264,2448,19,13
photo-110.jpg,1,1311,1329,994,1011,4,3264,2448,18,17
photo-110.jpg,1,1347,1365,998,1010,1,3264,2448,18,12
photo-110.jpg,1,1356,1375,1722,1736,1,3264,2448,19,14
photo-110.jpg,1,1382,1400,994,1024,15,3264,2448,18,30
photo-110.jpg,1,1418,1436,993,1009,2,3264,2448,18,16
photo-110.jpg,1,1427,1445,1720,1735,2,3264,2448,18,15
photo-110.jpg,1,1453,1471,994,1009,2,3264,2448,18,15
photo-110.jpg,1,1489,1506,992,1009,2,3264,2448,17,17
photo-110.jpg,1,1524,1542,992,1023,23,3264,2448,18,31
photo-110.jpg,1,1556,1575,699,786,17.600,3264,2448,19,87
photo-110.jpg,1,1556,1574,587,658,35.20,3264,2448,18,71
photo-110.jpg,1,1559,1577,991,1007,2,3264,2448,18,16
photo-110.jpg,1,1569,1586,1718,1733,2,3264,2448,17,15
photo-111.jpg,2,1065,1086,1873,2158,THICK CREAM 5L BTL,3264,2448,21,285
photo-111.jpg,2,1096,1118,1810,2157,CW BAKERS FLOUR 12.5KG,3264,2448,22,347
photo-111.jpg,2,1129,1151,1794,2158,JALAPENOS SLICED A10 TIN,3264,2448,22,364
photo-111.jpg,2,1162,1184,1808,2157,SLICED PEPSRON1 - HANS 1,3264,2448,22,349
photo-111.jpg,2,1194,1217,1781,2157,BAM FRESH BASIL PSST02LT,3264,2448,23,376
photo-111.jpg,2,1228,1250,1825,2157,AIOLI GARLIC SAUC8 1KG,3264,2448,22,332
photo-111.jpg,2,1260,1284,1768,2157,FRENCH M HOLLANDAISE SAU,3264,2448,24,389
photo-111.jpg,2,1294,1317,1801,2157,CW LAUNDRY LIQUID SLT •,3264,2448,23,356
photo-111.jpg,2,1327,1350,1769,2157,CRUSHED TOMATOES RIV 10K,3264,2448,23,388
photo-111.jpg,2,1360,1383,1764,2157,WOMBAT CAESAR DRESSING 1,3264,2448,23,393
photo-111.jpg,2,1392,1416,1792,2156,GLOVES LG VINYL C-GV0005,3264,2448,24,364
photo-111.jpg,2,1426,1450,1774,2156,GLOVES MD VINYL C-GVOOQ2,3264,2448,24,382
photo-111.jpg,2,1459,1482,1782,2155,ROLL TOWEL PREM BOX (15X,3264,2448,23,373
photo-111.jpg,2,1492,1516,1782,2157,GLOVE XTR/LARGE PK100 PO,3264,2448,24,375
photo-111.jpg,2,1525,1550,1779,2155,MAINLAND MOZZ SHRED 2KG,3264,2448,25,376
photo-111.jpg,2,1559,1583,1793,2155,MLAND SWISS SLICE 1KG<10,3264,2448,24,362
photo-111.jpg,2,1591,1616,1814,2154,B/S YOGURT GREEK 10KC,3264,2448,25,340
photo-111.jpg,1,1040,1059,750,834,17.000,3264,2448,19,84
photo-111.jpg,1,1039,1056,644,712,51.00,3264,2448,17,68
photo-111.jpg,3,1072,1092,644,833,12.750 175.50,3264,2448,20,189
photo-111.jpg,1,1108,1125,749,818,0.500,3264,2448,17,69
photo-111.jpg,1,1106,1123,643,695,6.50,3264,2448,17,52
photo-111.jpg,1,1142,1160,750,831,12.250,3264,2448,18,81
photo-111.jpg,1,1140,1158,643,711,85.75,3264,2448,18,68
photo-111.jpg,1,1174,1193,748,832,22.850,3264,2448,19,84
photo-111.jpg,1,1172,1190,642,710,22.85,3264,2448,18,68
photo-111.jpg,1,1206,1226,747,817,8.750,3264,2448,20,70
photo-111.jpg,1,1205,1224,641,695,8.75,3264,2448,19,54
photo-111.jpg,1,1242,1259,747,816,5.850,3264,2448,17,69
photo-111.jpg,1,1240,1258,640,695,5.85,3264,2448,18,55
photo-111.jpg,1,1275,1294,746,829,13.750,3264,2448,19,83
photo-111.jpg,1,1273,1291,639,708,13.75,3264,2448,18,69
photo-111.jpg,1,1308,1327,745,828,13.280,3264,2448,19,83
photo-111.jpg,1,1307,1325,639,708,73.15,3264,2448,18,69
photo-111.jpg,1,1343,1361,745,814,7.200,3264,2448,18,69
photo-111.jpg,1,1341,1358,639,691,7.20,3264,2448,17,52
photo-111.jpg,3,1376,1394,743,811,3.1M,3264,2448,18,68
photo-111.jpg,3,1358,1393,546,690,3.A*—SP,3264,2448,35,144
photo-111.jpg,1,1409,1428,743,812,3.180,3264,2448,19,69
photo-111.jpg,1,1407,1426,636,690,3.18,3264,2448,19,54
photo-111.jpg,1,1443,1462,743,825,55.800,3264,2448,19,82
photo-111.jpg,1,1477,1495,742,811,3.180,3264,2448,18,69
photo-111.jpg,3,1467,1493,562,703,22.33^>r,3264,2448,26,141
photo-111.jpg,3,1509,1529,634,823,15.850 705.00,3264,2448,20,189
photo-111.jpg,1,1544,1563,740,823,17.000,3264,2448,19,83
photo-111.jpg,1,1543,1562,633,701,35.20,3264,2448,19,68
photo-111.jpg,1,1577,1596,739,822,30.850,3264,2448,19,83
photo-111.jpg,1,1576,1594,632,701,30.85,3264,2448,18,69
photo-111.jpg,1,1043,1063,876,945,0.000,3264,2448,20,69
photo-111.jpg,1,1077,1096,876,944,0.000,3264,2448,19,68
photo-111.jpg,1,1111,1129,874,944,0.000,3264,2448,18,70
photo-111.jpg,1,1145,1164,875,943,0.000,3264,2448,19,68
photo-111.jpg,1,1177,1196,874,942,0.000,3264,2448,19,68
photo-111.jpg,1,1211,1229,873,942,0.000,3264,2448,18,69
photo-111.jpg,1,1245,1262,871,940,0.000,3264,2448,17,69
photo-111.jpg,1,1278,1296,871,939,1.250,3264,2448,18,68
photo-111.jpg,1,1311,1330,871,939,0.000,3264,2448,19,68
photo-111.jpg,1,1345,1363,870,939,0.000,3264,2448,18,69
photo-111.jpg,1,1377,1396,869,938,0.280,3264,2448,19,69
photo-111.jpg,1,1413,1429,869,937,0.280,3264,2448,16,68
photo-111.jpg,1,1445,1463,868,936,5.300,3264,2448,18,68
photo-111.jpg,1,1479,1497,867,936,2.030,3264,2448,18,69
photo-111.jpg,1,1513,1531,866,935,0.000,3264,2448,18,69
photo-111.jpg,1,1547,1565,865,934,0.000,3264,2448,18,69
photo-111.jpg,1,1580,1597,864,933,0.000,3264,2448,17,69
photo-111.jpg,1,1048,1067,1028,1044,3,3264,2448,19,16
photo-111.jpg,1,1061,1080,1710,1725,3,3264,2448,19,15
photo-111.jpg,1,1095,1113,1709,1739,14,3264,2448,18,30
photo-111.jpg,1,1128,1145,1712,1723,1,3264,2448,17,11
photo-111.jpg,1,1161,1180,1709,1725,7,3264,2448,19,16
photo-111.jpg,1,1193,1211,1712,1723,1,3264,2448,18,11
photo-111.jpg,1,1226,1244,1712,1724,1,3264,2448,18,12
photo-111.jpg,1,1260,1277,1711,1722,1,3264,2448,17,11
photo-111.jpg,1,1293,1310,1711,1723,1,3264,2448,17,12
photo-111.jpg,1,1326,1344,1708,1723,4,3264,2448,18,15
photo-111.jpg,1,1360,1376,1712,1722,1,3264,2448,16,10
photo-111.jpg,1,1392,1409,1711,1721,1,3264,2448,17,10
photo-111.jpg,1,1425,1442,1711,1722,1,3264,2448,17,11
photo-111.jpg,1,1459,1475,1711,1722,1,3264,2448,16,11
photo-111.jpg,1,1491,1511,1706,1722,7,3264,2448,20,16
photo-111.jpg,1,1525,1544,1707,1737,45,3264,2448,19,30
photo-111.jpg,1,1082,1100,1027,1057,14,3264,2448,18,30
photo-111.jpg,1,1116,1133,1029,1043,1,3264,2448,17,14
photo-111.jpg,1,1149,1166,1027,1044,7,3264,2448,17,17
photo-111.jpg,1,1181,1199,1029,1041,1,3264,2448,18,12
photo-111.jpg,1,1214,1232,1028,1041,1,3264,2448,18,13
photo-111.jpg,1,1247,1265,1027,1039,1,3264,2448,18,12
photo-111.jpg,1,1281,1300,1026,1039,1,3264,2448,19,13
photo-111.jpg,1,1314,1332,1023,1039,4,3264,2448,18,16
photo-111.jpg,1,1348,1366,1026,1038,1,3264,2448,18,12
photo-111.jpg,1,1381,1399,1024,1037,1,3264,2448,18,13
photo-111.jpg,3,1415,1432,1023,1036,i,3264,2448,17,13
photo-111.jpg,1,1448,1466,1023,1036,1,3264,2448,18,13
photo-111.jpg,1,1481,1499,1020,1036,7,3264,2448,18,16
photo-111.jpg,1,1515,1534,1019,1049,45,3264,2448,19,30
photo-111.jpg,1,1549,1567,1018,1034,2,3264,2448,18,16
photo-111.jpg,1,1583,1600,1020,1033,1,3264,2448,17,13
photo-112.jpg,2,1089,1107,1908,2208,THICK CREAM 5L BTL,3264,2448,18,300
photo-112.jpg,2,1123,1141,1843,2206,CW BAKERS FLOUR 12-5KG,3264,2448,18,363
photo-112.jpg,2,1155,1176,1738,2208,AYAM COCONUT CREAM 400ML 12,3264,2448,21,470
photo-112.jpg,2,1192,1211,1843,2209,SLICED PEPERONI - HANS 1,3264,2448,19,366
photo-112.jpg,2,1225,1244,1814,2208,BAM FRESH BASIL PEST02LT,3264,2448,19,394
photo-112.jpg,2,1260,1279,1801,2209,CRUSHED TOMATOES RIV 10K,3264,2448,19,408
photo-112.jpg,2,1296,1314,1900,2212,ANCHOVIES 720GM TIN,3264,2448,18,312
photo-112.jpg,2,1330,1349,1829,2212,GLOVES LG VINYL C-GVOOOG,3264,2448,19,383
photo-112.jpg,2,1365,1384,1809,2212,GLOVES MD VINYL C-GV0002,3264,2448,19,403
photo-112.jpg,2,1399,1418,1820,2213,GLOVE XTR/LARGE PK100 PO,3264,2448,19,393
photo-112.jpg,2,1434,1453,1818,2213,MAINLAND MOZZ SHRED 2KG,3264,2448,19,395
photo-112.jpg,2,1469,1491,1834,2214,MLAND SWISS SLICE 1KG(10,3264,2448,22,380
photo-112.jpg,2,1505,1522,1862,2216,YEAST DRY ANGEST 500G,3264,2448,17,354
photo-112.jpg,1,1080,1099,730,817,17.000,3264,2448,19,87
photo-112.jpg,1,1077,1097,618,689,51.00,3264,2448,20,71
photo-112.jpg,3,1113,1133,618,816,12.750 153.00,3264,2448,20,198
photo-112.jpg,1,1151,1168,730,801,2.900,3264,2448,17,71
photo-112.jpg,1,1148,1166,618,689,34.50,3264,2448,18,71
photo-112.jpg,1,1186,1203,730,816,12.250,3264,2448,17,86
photo-112.jpg,1,1184,1203,617,689,98.00,3264,2448,19,72
photo-112.jpg,1,1219,1237,729,816,22.950,3264,2448,18,87
photo-112.jpg,1,1218,1237,617,689,22.95,3264,2448,19,72
photo-112.jpg,1,1254,1273,729,815,18.290,3264,2448,19,86
photo-112.jpg,1,1253,1271,617,688,73.16,3264,2448,18,71
photo-112.jpg,1,1290,1308,729,815,10.250,3264,2448,18,86
photo-112.jpg,1,1289,1307,616,687,10.25,3264,2448,18,71
photo-112.jpg,1,1325,1342,728,800,3.190,3264,2448,17,72
photo-112.jpg,1,1360,1378,728,800,3.190,3264,2448,18,72
photo-112.jpg,1,1396,1413,728,800,3.190,3264,2448,17,72
photo-112.jpg,1,1395,1413,616,686,15.95,3264,2448,18,70
photo-112.jpg,3,1429,1448,615,814,15.950 861.30,3264,2448,19,199
photo-112.jpg,1,1465,1483,727,814,17.600,3264,2448,18,87
photo-112.jpg,1,1465,1483,615,686,35.20,3264,2448,18,71
photo-112.jpg,1,1502,1519,727,799,2.500,3264,2448,17,72
photo-112.jpg,1,1501,1519,615,685,50.00,3264,2448,18,70
photo-112.jpg,1,1081,1100,862,933,0.000,3264,2448,19,71
photo-112.jpg,1,1116,1134,862,933,0.000,3264,2448,18,71
photo-112.jpg,1,1151,1169,862,933,0.000,3264,2448,18,71
photo-112.jpg,1,1187,1204,862,932,0.000,3264,2448,17,70
photo-112.jpg,1,1220,1238,860,932,0.000,3264,2448,18,72
photo-112.jpg,1,1255,1273,860,932,0.000,3264,2448,18,72
photo-112.jpg,1,1290,1308,860,932,0.000,3264,2448,18,72
photo-112.jpg,1,1326,1343,860,931,0.580,3264,2448,17,71
photo-112.jpg,1,1361,1378,860,932,0.580,3264,2448,17,72
photo-112.jpg,1,1396,1413,860,931,1.450,3264,2448,17,71
photo-112.jpg,1,1430,1448,860,931,0.000,3264,2448,18,71
photo-112.jpg,1,1467,1484,860,931,0.000,3264,2448,17,71
photo-112.jpg,1,1502,1519,860,931,0.000,3264,2448,17,71
photo-112.jpg,1,1084,1101,1022,1037,3,3264,2448,17,15
photo-112.jpg,1,1087,1104,1738,1753,3,3264,2448,17,15
photo-112.jpg,1,1122,1139,1738,1768,12,3264,2448,17,30
photo-112.jpg,1,1225,1242,1742,1753,1,3264,2448,17,11
photo-112.jpg,1,1260,1277,1738,1754,4,3264,2448,17,16
photo-112.jpg,1,1330,1347,1740,1755,2,3264,2448,17,15
photo-112.jpg,1,1364,1382,1740,1755,2,3264,2448,18,15
photo-112.jpg,1,1399,1417,1741,1755,5,3264,2448,18,14
photo-112.jpg,1,1434,1451,1742,1771,54,3264,2448,17,29
photo-112.jpg,1,1118,1136,1022,1052,12,3264,2448,18,30
photo-112.jpg,1,1153,1170,1022,1052,12,3264,2448,17,30
photo-112.jpg,1,1188,1205,1022,1037,8,3264,2448,17,15
photo-112.jpg,1,1191,1208,1739,1754,8,3264,2448,17,15
photo-112.jpg,1,1221,1239,1024,1036,1,3264,2448,18,12
photo-112.jpg,1,1256,1275,1020,1037,4,3264,2448,19,17
photo-112.jpg,1,1292,1309,1024,1035,1,3264,2448,17,11
photo-112.jpg,1,1295,1312,1742,1754,1,3264,2448,17,12
photo-112.jpg,1,1327,1344,1021,1036,2,3264,2448,17,15
photo-112.jpg,1,1324,1342,616,672,6.38,3264,2448,18,56
photo-112.jpg,1,1360,1377,616,671,6.38,3264,2448,17,55
photo-112.jpg,1,1362,1380,1021,1036,2,3264,2448,18,15
photo-112.jpg,1,1397,1414,1021,1035,5,3264,2448,17,14
photo-112.jpg,1,1431,1449,1021,1051,54,3264,2448,18,30
photo-112.jpg,1,1467,1484,1021,1036,2,3264,2448,17,15
photo-112.jpg,1,1469,1486,1742,1757,2,3264,2448,17,15
photo-112.jpg,1,1502,1520,1021,1051,20,3264,2448,18,30
photo-112.jpg,1,1504,1521,1743,1773,20,3264,2448,17,30
photo-113.jpg,2,1105,1128,1894,2182,THICK CREAM 5L BTL,3264,2448,23,288
photo-113.jpg,2,1137,1160,1832,2182,CW BAKERS FLOUR 12.5KG,3264,2448,23,350
photo-113.jpg,2,1169,1194,1731,2183,AYAM COCONUT CREAM 400ML 12,3264,2448,25,452
photo-113.jpg,2,1204,1228,1818,2183,JALAPEMOS SLICED A10 TIN,3264,2448,24,365
photo-113.jpg,2,1238,1262,1830,2182,SLICED PEPERONI - HANS 1,3264,2448,24,352
photo-113.jpg,2,1271,1295,1805,2182,BAM FRESH BASIL PEST02LT,3264,2448,24,377
photo-113.jpg,2,1305,1328,1791,2183,CRUSHED TOMATOES RIV 10K,3264,2448,23,392
photo-113.jpg,2,1340,1362,1839,2182,PIECES RAW CASHEW 1KG,3264,2448,22,343
photo-113.jpg,2,1373,1396,1809,2183,MOROCCAN SEASONING 1KG,3264,2448,23,374
photo-113.jpg,2,1407,1430,1810,2183,HEINZ TOMATO PASTE 3.15K,3264,2448,23,373
photo-113.jpg,2,1441,1464,1817,2184,GLOVES LG VINYL C-GV0006,3264,2448,23,367
photo-113.jpg,2,1474,1496,1798,2184,GLOVES MD VINYL C-CV0002,3264,2448,22,386
photo-113.jpg,2,1511,1532,1879,2185,TEASPOON WHITE (100),3264,2448,21,306
photo-113.jpg,2,1542,1565,1807,2185,GLOVE XTR/LARGE PK100 PO,3264,2448,23,378
photo-113.jpg,2,1576,1598,1804,2184,MAINLAND MOZZ SHRED 2KG,3264,2448,22,380
photo-113.jpg,2,1610,1634,1819,2185,ML AND SWISS SLICE 1KG(10,3264,2448,24,366
photo-113.jpg,2,1646,1667,1840,2184,B/S YOGURT GREEK 10KG,3264,2448,21,344
photo-113.jpg,1,1090,1108,873,943,0.000,3264,2448,18,70
photo-113.jpg,1,1124,1142,873,943,0.000,3264,2448,18,70
photo-113.jpg,1,1157,1175,873,942,0.000,3264,2448,18,69
photo-113.jpg,1,1191,1210,872,942,0.000,3264,2448,19,70
photo-113.jpg,1,1225,1245,872,941,0.000,3264,2448,20,69
photo-113.jpg,1,1260,1278,871,941,0.000,3264,2448,18,70
photo-113.jpg,1,1294,1312,872,941,0.000,3264,2448,18,69
photo-113.jpg,1,1329,1346,872,941,0.000,3264,2448,17,69
photo-113.jpg,1,1363,1381,871,941,0.000,3264,2448,18,70
photo-113.jpg,1,1397,1416,870,940,0.000,3264,2448,19,70
photo-113.jpg,1,1431,1449,870,940,0.500,3264,2448,18,70
photo-113.jpg,1,1467,1484,870,939,0.290,3264,2448,17,69
photo-113.jpg,1,1501,1518,869,938,0.414,3264,2448,17,69
photo-113.jpg,1,1535,1553,868,938,1.740,3264,2448,18,70
photo-113.jpg,1,1569,1588,868,938,0.000,3264,2448,19,70
photo-113.jpg,1,1605,1623,1025,1040,2,3264,2448,18,15
photo-113.jpg,1,1604,1622,867,938,0.000,3264,2448,18,71
photo-113.jpg,3,1640,1660,867,1040,1 °’oo°,3264,2448,20,173
photo-113.jpg,3,1676,1696,864,1050,GST Total $ 3JJ2,3264,2448,20,186
photo-113.jpg,1,1093,1109,1030,1045,4,3264,2448,16,15
photo-113.jpg,1,1087,1106,745,830,17.000,3264,2448,19,85
photo-113.jpg,1,1084,1103,635,704,00.00,3264,2448,19,69
photo-113.jpg,3,1119,1140,634,829,12.750 102.00,3264,2448,21,195
photo-113.jpg,1,1155,1174,744,813,2.900,3264,2448,19,69
photo-113.jpg,1,1153,1172,634,704,34.00,3264,2448,19,70
photo-113.jpg,1,1190,1208,743,813,5.500,3264,2448,18,70
photo-113.jpg,1,1187,1206,633,703,13.00,3264,2448,19,70
photo-113.jpg,1,1224,1242,743,828,12.250,3264,2448,18,85
photo-113.jpg,1,1222,1241,633,703,05.75,3264,2448,19,70
photo-113.jpg,1,1258,1277,742,828,22.950,3264,2448,19,86
photo-113.jpg,1,1256,1275,632,703,45.90,3264,2448,19,71
photo-113.jpg,1,1293,1311,742,827,10.290,3264,2448,18,85
photo-113.jpg,1,1291,1310,632,702,73.16,3264,2448,19,70
photo-113.jpg,1,1328,1346,742,826,12.000,3264,2448,18,84
photo-113.jpg,1,1326,1344,632,702,25.20,3264,2448,18,70
photo-113.jpg,1,1361,1380,741,827,12.500,3264,2448,19,86
photo-113.jpg,1,1359,1379,631,702,25.00,3264,2448,20,71
photo-113.jpg,1,1396,1414,741,811,9.950,3264,2448,18,70
photo-113.jpg,1,1394,1413,631,701,19.90,3264,2448,19,70
photo-113.jpg,1,1430,1449,740,811,3.190,3264,2448,19,71
photo-113.jpg,3,1429,1448,608,685,0.30 •*,3264,2448,19,77
photo-113.jpg,1,1466,1483,740,811,3.190,3264,2448,17,71
photo-113.jpg,1,1463,1482,629,685,3.19,3264,2448,19,56
photo-113.jpg,1,1500,1518,739,810,1.518,3264,2448,18,71
photo-113.jpg,3,1492,1516,590,684,4.55 /,3264,2448,24,94
photo-113.jpg,1,1535,1552,739,809,3.190,3264,2448,17,70
photo-113.jpg,1,1534,1551,627,699,19.14,3264,2448,17,72
photo-113.jpg,3,1568,1587,628,824,15.950 705.00,3264,2448,19,196
photo-113.jpg,1,1604,1621,738,823,17.000,3264,2448,17,85
photo-113.jpg,1,1602,1621,628,698,35.20,3264,2448,19,70
photo-113.jpg,1,1640,1657,738,823,20.950,3264,2448,17,85
photo-113.jpg,1,1639,1656,627,698,20.95,3264,2448,17,71
photo-113.jpg,1,1204,1221,1731,1746,2,3264,2448,17,15
photo-113.jpg,1,1271,1288,1731,1745,2,3264,2448,17,14
photo-113.jpg,1,1305,1322,1730,1746,4,3264,2448,17,16
photo-113.jpg,1,1373,1390,1731,1745,2,3264,2448,17,14
photo-113.jpg,1,1407,1424,1731,1745,2,3264,2448,17,14
photo-113.jpg,1,1441,1458,1731,1745,2,3264,2448,17,14
photo-113.jpg,1,1475,1492,1733,1745,1,3264,2448,17,12
photo-113.jpg,1,1542,1560,1731,1745,0,3264,2448,18,14
photo-113.jpg,1,1576,1594,1731,1760,48,3264,2448,18,29
photo-113.jpg,1,1610,1629,1730,1745,2,3264,2448,19,15
photo-113.jpg,1,1103,1119,1729,1745,4,3264,2448,16,16
photo-113.jpg,1,1127,1144,1030,1045,8,3264,2448,17,15
photo-113.jpg,1,1137,1153,1731,1745,8,3264,2448,16,14
photo-113.jpg,1,1160,1178,1029,1059,12,3264,2448,18,30
photo-113.jpg,1,1195,1212,1029,1044,2,3264,2448,17,15
photo-113.jpg,1,1228,1246,1029,1044,7,3264,2448,18,15
photo-113.jpg,1,1237,1255,1731,1746,7,3264,2448,18,15
photo-113.jpg,1,1262,1280,1029,1044,2,3264,2448,18,15
photo-113.jpg,1,1297,1314,1028,1044,4,3264,2448,17,16
photo-113.jpg,1,1331,1348,1028,1043,2,3264,2448,17,15
photo-113.jpg,1,1339,1357,1731,1745,2,3264,2448,18,14
photo-113.jpg,1,1365,1382,1028,1043,2,3264,2448,17,15
photo-113.jpg,1,1399,1416,1028,1043,2,3264,2448,17,15
photo-113.jpg,1,1433,1452,1027,1042,2,3264,2448,19,15
photo-113.jpg,1,1468,1485,1030,1042,1,3264,2448,17,12
photo-113.jpg,1,1503,1520,1027,1042,3,3264,2448,17,15
photo-113.jpg,1,1508,1526,1731,1745,3,3264,2448,18,14
photo-113.jpg,1,1537,1554,1027,1041,6,3264,2448,17,14
photo-113.jpg,1,1572,1588,1027,1054,48,3264,2448,16,27
photo-113.jpg,1,1646,1663,1732,1744,1,3264,2448,17,12
